功夫3D	功夫
再见，我的妾	霸王别姬
十分大师－小号篇	十分钟年华老去：小号篇
十分钟前：小号响起	十分钟年华老去：小号篇
十分钟，年华老去（上）	十分钟年华老去：小号篇
17岁的单车	十七岁的单车
自行车	十七岁的单车
北京自行车	十七岁的单车
西遊記大結局之仙履奇緣	大话西游之大圣娶亲
西游记完结篇仙履奇缘	大话西游之大圣娶亲
齐天大圣西游记	大话西游之大圣娶亲
大话东游之二	大话西游之大圣娶亲
新龍門客棧	新龙门客栈
人生	活着
黃飛鴻之三獅王爭霸	黄飞鸿之三：狮王争霸
黄飞鸿3	黄飞鸿之三：狮王争霸
黄飞鸿之狮王争霸	黄飞鸿之三：狮王争霸
面王	变脸
面具之王	变脸
黃飛鴻之四王者之風	黄飞鸿之四：王者之风
黄飞鸿之王者之风	黄飞鸿之四：王者之风
中華英雄	中华英雄
华英雄	中华英雄
始皇帝暗杀	荆轲刺秦王
刺秦	荆轲刺秦王
一个也不能少	一个都不能少
風雲雄霸天下	风云雄霸天下
无政府主义	天地男儿之激进党员
晚报新闻	有话好好说
紅玫瑰白玫瑰	红玫瑰白玫瑰
红玫瑰与白玫瑰	红玫瑰白玫瑰
新天龍八部之天山童姥	新天龙八部之天山童姥
天龙八部之天山童姥	新天龙八部之天山童姥
天山童姥	新天龙八部之天山童姥
南京1937	南京大屠杀
1937南京记忆	南京大屠杀
水滸傳之英雄本色	水浒传之英雄本色
英雄本色	水浒传之英雄本色
浪漫樱花	芭啦芭啦樱之花
打左灯，向右转	红灯停，绿灯行
金枝泪	豆花女
世上只有妈妈好	豆花女
海灘的一天	海滩的一天
一刀傾城	一刀倾城
神州第一刀	一刀倾城
商客 镖客	金客
断了的弦	边走边唱
命若琴弦	边走边唱
西遊記第壹佰零壹回之月光寶盒	大话西游之月光宝盒
西游记101回月光宝盒	大话西游之月光宝盒
齐天大圣东游记	大话西游之月光宝盒
大话东游之一	大话西游之月光宝盒
半生緣	半生缘
国姓爷合战	英雄郑成功
趁热打劫	埋伏
大隻佬	大块头有大智慧
大只佬	大块头有大智慧
臥虎藏龍	卧虎藏龙
背着爸爸上学去	背起爸爸上学
宋家三姐妹	宋家皇朝
宋氏三姐妹	宋家皇朝
宋家の三姉妹	宋家皇朝
曼荼羅　若き日の弘法大師・空海	曼荼罗
我的失忆男友	失忆界女王
秘语拾柒小时	秘语十七小时
秘语17小时	秘语十七小时
醉拳Ⅲ	醉拳3
醉拳三	醉拳3
燃情男狙擊	燃情狙击手
鬼迷心竅	鬼迷心窍
惊吓王	鬼迷心窍
天剑绝刀	侠女传奇
天剑绝刀之独孤九剑	侠女传奇
新侠女	侠女传奇
我家有一隻河東獅	河东狮吼
站直鹋肯	站直啰，别趴下
待到春花烂漫时	开往春天的地铁
怪談之魔鏡	古镜怪谈
怪谈之魔镜	古镜怪谈
午夜凶镜	古镜怪谈
中国版午夜凶铃	古镜怪谈
过着狼狈不堪的生活	一声叹息
李连英	大太监李莲英
天下无爱	新十字街头
离婚后不要来找我	离婚
庭院中的女人	庭院里的女人
阿拉来的一个美国孙子	上海假期
惊天传奇	神话
钛雨	神话
畫皮之陰陽法王	画皮之阴阳法王
特区特警	天网行动
超級大國民	超级大国民
灿烂公厕	男男女女
榴槤飄飄	榴莲飘飘
無間道III 終極無間	无间道3：终极无间
一生一台戲	一生一台戏
大决战第三部：平津战役	大决战之平津战役
平津战役	大决战之平津战役
那山、那人、那狗	那山那人那狗
那山，那人，那狗	那山那人那狗
背对背，脸对脸	背靠背，脸对脸
秋风醉了	背靠背，脸对脸
馬戲小子	马戏小子
江湖情未了	马戏小子
破军之战	马戏小子
藍宇	蓝宇
我爱北京	夏日暖洋洋
爱情命运号	爱情梦幻号
幸福大街	红西服
故郷の香り	暖
诸葛孔明	一代枭雄曹操
三国演义之诸葛孔明	一代枭雄曹操
三国演义之一代枭雄曹操	一代枭雄曹操
地下鐵	地下铁
千机变2之花都大战	千机变Ⅱ花都大战
枪林恋曲	爱‧作战
北京痴男怨女(港)	大撒把
我的一九一九	我的1919
我十九	青红
米	大鸿米店
追击八月十五	追击8月15
抹茶之恋味	鸳鸯蝴蝶
十面攻敌	举起手来！
戀愛地圖	恋爱地图
大话情圣	恋爱地图
关于爱	恋爱地图
冤家父子	我是你爸爸
懸戀	悬恋
红豆	悬恋
世纪末的对话	悬恋
以刑警的名义	蓝色爱情
黑駿馬	黑骏马
爱在草原的天空(港)	黑骏马
断刀客	刀
灵异幽息	窒息
无思い出の夏	王首先的夏天
昆仑关大捷	铁血昆仑关
血战南宁	铁血昆仑关
出口	铁血昆仑关
铁血	铁血昆仑关
疑云杀机(台)	不朽的园丁
无国界追凶(港)	不朽的园丁
哥斯拉终极战	哥斯拉之终极战役
哥吉拉最后战役	哥斯拉之终极战役
大决战第二部：淮海战役	大决战之淮海战役
淮海战役	大决战之淮海战役
大决战第一部：辽沈战役	大决战之辽沈战役
泪女	哭泣的女人
梦影童年	电影往事
心心	心·心
铁道游击队	飞虎队
救命2怪物	怪物
桂林荣记	花桥荣记
爱在遥远的附近(港)	面纱
猜心(台)	面纱
兄弟	我们
绝对隐私系列	我们
清凉寺的钟声	清凉寺钟声
乳泉村の子	清凉寺钟声
日，我的太阳	我的太阳
穆斯林的葬礼	月落玉长河
停车暂借问	烟雨红颜
四个厨师一围菜	春风得意梅龙镇
验身	五魁
呉清源　極みの棋譜	吴清源
阿斯匹林	阿司匹林
古城童话	再见，我们的1948
武林圣斗士	东瀛游侠
荡寇英雄	东瀛游侠
赤壁	赤壁(上)
没有原告的杀人事件(港)	被告山杠爷
滑稽人	上一当
小红花	看上去很美
完美女人	井盖儿
我为谁狂	井盖儿
沉沦	幸福从邪恶中穿行
绝对隐私系列	幸福从邪恶中穿行
我的非典女友	三十八度
38度	三十八度
无敌铁沙掌	无敌铁砂掌
龙虎三皇	龙虎门
蒙古乒乓	绿草地
闪灵凶猛	动物凶灵
黑白	黑白摄影工作室杀人事件
錯體追擊組合	错体追击组合
猎狐	错体追击组合
老少爷们打鬼子	绝境逢生
弘一法师	一轮明月
刀客	关中刀客之愤操子
血溅天地帮	关中刀客之七寸子
我的蓝莓之夜	蓝莓之夜
目的地上海	目的地，上海
神力女超人(台)	神奇女侠
上车，走吧	上车走吧
野蛮必杀技	野蛮秘笈
贴身欲女	处女作
卡车小提琴	卡车上掉下的小提琴
怀孕	结果
太阳再次升起	太阳照常升起
妈妈再爱我一次2	母亲快乐
中国功夫少女组	空手道少女组
寒冰	消失的女人
绝对隐私系列	渴望一份真爱的感觉
绝对隐私系列	赵军的秘密
绝对隐私系列	人在北京
绝对隐私系列	冯齐的忏悔
绝对隐私系列	陈越的婚纱
绝对隐私系列	别提过去别问将来
夜の上海	夜·上海
夜上海	夜·上海
夜。上海	夜·上海
新版西岳奇童	西岳奇童
爱在路上	爱·在路上
魔比斯环3D	魔比斯环
魔必尔斯环	魔比斯环
阴阳界	门
那木错	七月
色|戒	色，戒
色·戒	色，戒
色戒	色，戒
原谅我又一次撒了谎	原谅我，又一次撒了谎
落叶(原名)	落叶归根
回家	落叶归根
叶落归根	落叶归根
寶貝計劃	宝贝计划
BB计划	宝贝计划
茄子(原名)	好奇害死猫
我的大嚿父母	外来媳妇本地郎
皆大欢喜	外来媳妇本地郎
我亚妈发仔瘟	花街欢乐坊
我的黑道老婆3	我的老婆是大佬3
我的老婆是黑社会3	我的老婆是大佬3
长江哀歌	三峡好人
大路	狭路英豪
龙腾中国	狭路英豪
終極忍者	终极忍者
战神再现	终极忍者
爱情短讯	短信一月追
杀人游戏	天黑请闭眼
美国人在中国	中国月亮
誓言	心中有鬼
永远的楠溪江	楠溪江
终极衡量	最后一搏
乡村行动	光荣的愤怒
黄石任务	黄石的孩子
战火逃城.	黄石的孩子
牛奶风尚	牛奶时尚
三言二拍之郑月娥从良记	胭楼记
胭脂记	胭楼记
百分百爱你	初恋的故事
追风筝的孩子	追风筝的人
王様の漢方(日)	汉方道
王道之中药	汉方道
双J计划	功夫之王
血战新世纪(港)	最后的吸血鬼
血战：最后的吸血鬼(台)	最后的吸血鬼
小夜刀	最后的吸血鬼
大电影之数百亿	大电影
贫嘴张大民的幸福生活之美丽的家	美丽的家
野孩子的秘密(台)	房东老爸
房东爸爸	房东老爸
何处是儿家	房东老爸
男生女生配	好孩子
流氓学生	好孩子
刺马	投名状
见龙卸甲	三国之见龙卸甲
远东国际大审判	东京审判
权杖	唐卡迷踪
里克·汉森：龙之心	龙之心
灌篮	大灌篮
功夫灌篮	大灌篮
灌篮高手	大灌篮
长江7号	长江七号
萨仁图雅	图雅的婚事
迷失北京	苹果
天下有贼100个	100个
调包	十全十美之相聚北京
3·温暖	第三种温暖
了凡四訓	了凡四训
诗意的年代	小说
刀子和刀子	十三棵泡桐
導火線	导火线
破军	导火线
長生殿	长生殿
女人有毒	双食记
照相机	寄生人
幽灵信箱	信箱
天子驕龍	天子骄龙
精武侠缘	天子骄龙
精武小英雄	天子骄龙
小毛头大英雄	天子骄龙
水浒人物谱之母夜叉孙二娘	母夜叉孙二娘
回家路	盲山
一个独生女儿的故事	一个独生女的故事
风的另一头(台)	风的另一边
风的另一侧	风的另一边
每當變幻時	每当变幻时
梁祝恨	梁山伯与祝英台新传
老左正传	老港正传
老少無猜	生旦净末
喜欢你喜欢我	恋爱大赢家
谜尸	深海寻人
银牌车手	疯狂的赛车
闪闪的红星之红星小勇士	闪闪的红星
闪闪的红星之孩子的天空(港)	闪闪的红星
连环局	绑架
格斗之王	真人快打：毁灭
畫皮	画皮
塑料城市	荡寇
勾魂妻	陶器人形
炼金之旅	牧羊少年奇幻之旅
我想有个家	暖春
七·七事变	七七事变
缘分2000	缘，妙不可言
女足九号	女足9号
与梦同飞	梦影长空
張保仔	张保仔
武状元张保仔	张保仔
怒海侠盗	张保仔
没事偷着乐2	有钱不一定就是爷
谈谈心，恋恋爱	谈谈心恋恋爱
永乐恩仇	武僧
A Friend From Ocean（外文名）	海洋朋友
三言二拍之毡笠缘	毡笠缘
舉自塵土	举自尘土
美梦人生	灰色大佬
你好大腕	灰色大佬
泰女情恨	傣女情恨
军人本色	我的左手
鳳凰 わが愛	凤凰
思い出の西幹道	西干道
1978年、冬。	西干道
大转折 下集 挺进大别山	大转折——挺进大别山
大顺店	天尽头
今股奇缘	大话股神
少女革命	麻雀要革命
麥兜響當當	麦兜响当当
麦兜武当	麦兜响当当
麦兜故事4	麦兜响当当
兄弟之生死同盟	兄弟
回家的路之疯狂直播秀	回家的路
听妈妈的话	回家的路
欲奴	遗落荒原的爱
星语心愿	山顶上的钟声
绝顶边缘	山顶上的钟声
爱在茶乡	茶色生香
有老鼠牌铅笔吗	暗号
约翰·拉贝	拉贝日记
绝龙路英豪	狂龙逞英豪
马背银行	烽火岁月
石榴可以这样吃	石榴的滋味
警戒	警徽
面对红十字	女大学生之死
迟桂花	金秋桂花迟
蓉城破晓	破晓
聂隐娘	刺客聂隐娘
第七传人(台)	第七子：降魔之战
猎魔七煞(港)	第七子：降魔之战
史布克的学徒	第七子：降魔之战
最后的学徒	第七子：降魔之战
第七子	第七子：降魔之战
好梦成真	祝你好运
情海	请将我遗忘
红草滩之刀神	红草滩
血溅狮王阵	南北雄狮
這兒是香格里拉	这儿是香格里拉
真味小霸王	真味小厨王
真味小和尚	真味小厨王
惬意的生活	我们的生活
赚他一千万	赚它一千万
父亲·爸爸 Father	红色年代
上海	谍海风云
保持通話	保持通话
赤裸孽缘	青春旷野
不会说话的爱情	活着爱着乐着
女捕快之迷局	女神捕之迷局
生死极速	极度险情
我是乡巴佬	超生游击队
沙镇的故事	耗尽一生
奇异家族	神秘世界历险记
夏至 A Summer Way	夏至
西門無恨	楚留香后传之西门无恨
卡门《the fat girl》	卡门
夏日物语	感光夏日
温良忠厚的诈骗犯	诈骗犯
扣篮Slam	扣篮对决
麦包系列之大唐风云	大唐风云
江山·美人	江山美人
功夫老爹	功夫老爸
铜马铁燕传奇	少林十八小铜人
乌龙巡警2(台)	超级骑警2
情迷女人心	歌声迷影
叠影杀机	歌声迷影
死亡列车	惊天东方号
跟你没完	咱俩没完
奇特缩形者	奇怪的收缩人
复仇的子弹	小鬼特种兵
W-布什传记	小布什传
殊不简单	小布什传
W的故事	小布什传
布什	小布什传
迷果	秘岸
少年	秘岸
橙乡天使	赣南之恋
三无流浪记	搏击赌庄
狙击英雄 张桃芳	狙击英雄
中国新纪录片糸列之狙击英雄	狙击英雄
神兵小将：电影版	神兵小将
地产大亨	大富翁
赌神风云	赌王出山
中国赌王	赌王出山
灵车	心灵之车
龙虎群英	贼头
第一人	登月第一人
登月先锋(台)	登月第一人
爱月之人(豆友译名)	登月第一人
九降风之中国大陆篇	摊开你的地图
裸浴	情人的血特别红
珍珠衫	金瓶少女
玄女幽魂	九天玄女
蛊咒传奇	九天玄女
小狐狸的故事之二	智斗乌鸦
羽坛冠军的日记	闪光的羽毛
车站	等你回来
我在霞村的时候	贞贞
葉問	叶问
一代宗师·叶问	叶问
聊斋之白秋练	白秋练
24城记	二十四城记
二十四城故事	二十四城记
三月三	剑侠传奇
三言两拍之三月三	剑侠传奇
美国田园诗	美国牧歌
美国心风暴(台)	美国牧歌
美丽男孩(台)	漂亮男孩
我怎么能吃我爸爸	疯狂进化人
我为什么(不)吃我的父亲	疯狂进化人
哈哈哈	哈！哈！哈！
黄飞鸿之勇闯天下	勇闯天下
三国演义之诸葛孔明	诸葛孔明
无路可退	乡间路
乡野僻径	乡间路
弗兰克·辛纳特拉	辛纳特拉
新龙威小子	功夫梦
功夫小子	功夫梦
乌尔善版鬼吹灯	寻龙诀
鬼吹灯之寻龙诀	寻龙诀
鬼吹灯	寻龙诀
太平轮：乱世浮生I(台)	太平轮(上)
生死恋	太平轮(上)
猛龙怪客	虎胆追凶
唐山唐山	但愿人长久
野蠻小子(台)	新笑林小子之我最棒
青城山之恋	爱情狗
水浒英雄谱之杨志	青面兽杨志
怒江传奇	怒江魂
红河谷2：活寡	怒江魂
木匠过年	肥水别流外人田
血欲迷墙	犯罪分子
风流泸沽	风流的湖
美版阴风阵阵	阴风阵阵
窒息(台)	阴风阵阵
囚犯	六号特殊犯人
万山剿匪记	围剿
熊猫团圆路	熊猫回家路
黃沙·青草·紅太陽	黄沙·青草·红太阳
修复处女膜年代	故事无双
断指之声	故事无双
之 鉴证	自由的边缘
替补员工	替补职员
古刹幽魂	古庙倩魂
我非贪官情夫	沉默与谎言
霸王別姬	霸王别姬
聊斋之鬼狐	狐仙
鬼狐	狐仙
狐道	狐仙
大搜查	大搜查之女
聊齋電影全新系列 梅女	梅女
聊齋電影全新系列 香玉	香玉
聊齋電影全新系列 阿绣	阿绣
阿秀	阿绣
聊齋電影全新系列 狐仙馴悍記	狐仙驯悍记
聊齋電影全新系列 鬼宅	鬼宅
聊齋電影全新系列 狐俠	狐侠
聊齋電影全新系列 賈奉雉	贾奉雉
极盗战(台)	贼巢
贼斗(港)	贼巢
福尔摩斯&amp;华生	福尔摩斯与华生
银杏，银杏	爱有来生
毒魔(港)	毒液：致命守护者
猛毒(台)	毒液：致命守护者
毒液	毒液：致命守护者
曾侯乙编钟传奇	凤舞天下
追凶50年	追凶五十年
银饰Ⅱ床	火船
银饰2床	火船
北京2008：第29届奥林匹克运动会开幕式	2008年第29届北京奥运会开幕式
三言二拍之芙蓉屏	芙蓉屏
三言两拍之拉郎配	拉郎配
吉縣麟	吉县麟
三言二拍之画鸟记	画鸟记
荒宅勿入	长恨歌
回路杀手(台)	环形使者
时凶猎杀(港)	环形使者
三言两拍之行乐图	行乐图
香格里拉之恋	为了爱
追鬼伞	可可的魔伞
郎朗的歌——献给2008	郎朗的歌：献给2008
钟形罩	瓶中美人
你心换我心	我心不死
還我情心	我心不死
靈異殺手	我心不死
还我情心	我心不死
真爱收信中(台)	根西岛文学与土豆皮馅饼俱乐部
纳粹铁蹄下的密函情书(港)	根西岛文学与土豆皮馅饼俱乐部
根基岛的文学和土豆派协会	根西岛文学与土豆皮馅饼俱乐部
只杀陌生人(港	陌生人2
台)	陌生人2
太阳花籽	毛嗑儿
葵瓜子	毛嗑儿
毛嗑	毛嗑儿
女人1966	开着火车上北京
冬日	葛老爷子
爱失偿(港)	李米的猜想
李米的遭遇	李米的猜想
铁甲奇侠3(港)	钢铁侠3
钢铁人3(台)	钢铁侠3
铁人3	钢铁侠3
女神捕之记中计	女神捕之计中计
非常完美：夺爱大作战	非常完美
苏菲的复仇	非常完美
铁胆忠魂	步入辉煌
黑寡妇	飞天蜈蚣
父子神探（第一部）	父子神探之千年咒
国庆日	黄金周
生命攸关	地下的天空
井	地下的天空
唐布拉之恋 Love of Tangbula Grasslands	唐布拉之恋
与艾维共进晚餐	我与赫夫共进晚餐
踏入地狱	进入地狱
入冥	进入地狱
进入幽冥	进入地狱
远东特遣队 第1部 初试锋芒	远东特遣队之初试锋芒
快乐时光凶杀案	欢乐时光谋杀案
賤偵MADAM摷公仔(港)	欢乐时光谋杀案
上海八英里shanghai 8 miles	上海八英里
若桔若藜	若橘若藜
爱情在线	自新大陆
民工潮	农民工
惑星历险	禁忌星球
缘分的天空之我爱的人	爱情急转弯
父子神探（第四部）	父子神探之玫瑰园疑云
父子神探（第五部）	父子神探之神秘数字
父子神探（第三部）	父子神探之目击者
父子神探（第二部）	父子神探之双子座
天下无敌掌门人	拳神小子
追金行動	追金行动
雙村記	双村记
赤壁：决战天下	赤壁(下)
證人	证人
无梦之年	疼痛难忍
无梦之年	疼痛难忍
共和国名将·李志民军管包头	李志民军管包头
烈火男儿5	烈火男儿之超级英雄
南國風雲	南国风云
夺宝特攻	南国风云
护宝情侠	南国风云
九反岁月	南国风云
烈火男儿6	烈火男儿之隐患
惊蛰	十八个手印
少年英雄王二小	二小放牛郎
烈火男儿3	烈火男儿之荣誉
烈火男儿4	烈火男儿之队长的故事
烈火男儿1	烈火男儿之金斧头
李双良	愚公移山
喜羊羊与灰太狼1	喜羊羊与灰太狼之牛气冲天
温彻斯特鬼屋(台)	温彻斯特
聊斋之连琐	连琐
像界碑一样站立	中尉
冬日午后	俗事
通天神探狄仁杰	狄仁杰之通天帝国
竊聽風雲	窃听风云
寡男寡女	非常女·非常嫁
大电影2	大电影2.0：两个傻瓜的荒唐事
美仑美奂	心灵风暴
新邦尼和克莱德	邦尼和克莱德的故事
心灵渡口	代课老师
玉龙还珠	西湖传奇
沔阳风暴	沔州烽火
水浒人物谱之小李广花荣	小李广花荣
犹太士师参孙	参孙
愛到盡	爱到尽
盗墓者罗拉(港)	古墓丽影：源起之战
古墓奇兵(台)	古墓丽影：源起之战
新古墓丽影	古墓丽影：源起之战
神医大梦	黑灵芝
僵尸俏佳人	江南奇冤
水浒英雄谱之雷横与朱仝	雷横与朱仝
牛人之谁动了我的幸福	谁动了我的幸福
功夫廚神	功夫厨神
烈火男儿2	烈火男儿之见习英雄
烈火男儿之“业余”消防员	烈火男儿·业余消防员
倔强的萝卜	倔强萝卜
倔犟萝卜	倔强萝卜
小分队	截杀香阁寺
东风·雨	东风雨
叶问2	叶问2：宗师传奇
余震	唐山大地震
北侠欧阳春	春满风波楼
孔子：决战春秋(台)	孔子
抗日县长张问德	腾越殇魂
高黎贡山魂	腾越殇魂
沙漠公路	飞跃沙漠
勒诺·杜兰和哈罗德·莫里斯收藏的重要文物和私人物件,包括书籍、街头时尚和珠宝	勒诺·杜兰和哈罗德·莫里斯收藏的重要文物和私人物件，包括书籍、街头时尚和珠宝
三言两拍之玉堂春	玉堂春
赎妓	三言两拍之卖油郎
生死搜救	生死时刻
12猛汉(台)	12勇士
12壮士(港)	12勇士
骑兵团	12勇士
马背上的战士	12勇士
大內密探靈靈狗	大内密探灵灵狗
刑警张玉贵第一部	刑警张玉贵
刑警张玉贵1	刑警张玉贵
春风沉醉的晚上	春风沉醉的夜晚
春热	春风沉醉的夜晚
“王子”雄兵	王子雄兵
新倩女幽魂	倩女幽魂
聊斋之倩女幽魂	倩女幽魂
倩女幽魂2011	倩女幽魂
老城旧事	刺青怨
这个杀手不眨眼3	整七十码
崛起	崛起———5·12四川抗震救灾启示录
東邪西毒終極版	东邪西毒：终极版
8点35分	八点三十五分
少年星海	星海
前方，后方	前方后方
前方·后方	前方后方
兰草	我们天上见
伞	我们天上见
蘇乞兒	苏乞儿
真实的传奇	苏乞儿
香格里拉的野马	命悬800公里
法国电影学院短片  当爱变成习惯	当爱变成习惯
帕尔扎特格	铂格
让子弹飞一会儿	让子弹飞
火烧云	让子弹飞
刺杀毛泽东	旭日惊雷
神医安道全	碧瑶霜迷案
龙凤呈祥	石榴树上结樱桃
老耿的故事	油菜花开
晚安，科伦坡	晚安·科伦坡
兄弟	兄弟（two
我們	我们
红河劫	铜鼓
长江七号爱地球	长江7号爱地球
长江7号：动画版	长江7号爱地球
歲月神偷	岁月神偷
1969太空漫游	岁月神偷
精武风云	精武风云·陈真
夜行侠陈真	精武风云·陈真
陈真：精武风云	精武风云·陈真
友谊路	下一站
央视版马兰花	马兰花
电视电影马兰花	马兰花
06版马兰花	马兰花
叠影追凶	拉尔复仇记
极速先锋	拉尔复仇记
动画版白鹿原	麋鹿王
花田囍事2010	花田喜事2010
独生子	独生子，向上向下向左向右向前向后
剑雨江湖	剑雨
一代宗師	一代宗师
一代宗师3D	一代宗师
一代宗师终极版	一代宗师
杀手：代号47 II	杀手：代号47
唐吉可德	魔侠传之唐吉可德
童雨	童雨
航城	航行城市
借室还魂	等着你回来
力王	力王之黑色擂台
火车站旁边的红泥屋	红泥屋
火线追凶7	火线追凶之狂魔再现
火线追凶4	火线追凶之突然死亡
火线追凶6	火线追凶之惊魂宴
中英街	无言的界碑
水行侠(港	海王
台)	海王
潜水侠	海王
水人	海王
人鱼哥(豆友译名)	海王
撕裂的记忆 （HOLES）	撕裂的记忆
毛泽东与军规	第一军规
成都我爱你（下）	过去未来
兄弟新传之黑白之战	决战枭雄
超级拳霸	宝贝双龙
战龙	宝贝双龙
冲出亚洲	她来自台北
燃烧的生命	燃燒生命
广州大道	广州大道向南
火龙	火龙对决
恋上白骨精	终极匹配
链上“白骨精”	终极匹配
通緝犯	通缉犯
讲述艾滋病感染者的故事	我们的生活
放飞	放飞自由
色劫	早安北京
月光光新慌慌(台)	月光光心慌慌
万圣节归来	月光光心慌慌
万圣节11	月光光心慌慌
老丁的春天	前妻
天长地久	80'后
天长地久之伤害	80'后
分开我们就坠落	80'后
古镇	小镇
天梯	云上学堂
一个巨星的诞生(台)	一个明星的诞生
星梦情深(港)	一个明星的诞生
无名电影	欠债还情
全城热恋热辣辣	全城热恋
热辣辣	全城热恋
血债	赤色危机
赤色追击	赤色危机
徐海东血战町店	徐海东喋血町店
喜羊羊与灰太狼2之虎胆羊威(港)	喜羊羊与灰太狼之虎虎生威
喜羊羊与灰太狼2：虎虎生威	喜羊羊与灰太狼之虎虎生威
四大名捕	西风烈
Vertical Farm垂直牧场	垂直牧场
奥运总动员	大厨小兵
猫踢娜娜	猫科大战
三进士	八珍汤
寻儿记	八珍汤
水浒人物谱之拼命三郎石秀	拼命三郎石秀
那一年在西藏(台)	西藏往事
那一年我们在西藏	西藏往事
在金矿打工的人	掘金
B+偵探	B+侦探
虹猫蓝兔之功夫天音寺	虹猫蓝兔火凤凰
線人	线人
证人2之线人	线人
雪花与秘扇(台)	雪花秘扇
雪花和神秘的扇子	雪花秘扇
我和猫的故事	校园的猫
亲民院长王天祥	百姓法官
欲望背后	股市情潮
黑股	股市情潮
映红山村的桃花	樱桃
山楂树	山楂树之恋
天籁：一万年以后	一万年以后
痞子英雄	痞子英雄之全面开战
痞子英雄电影版	痞子英雄之全面开战
痞子英雄首部曲：全面开战	痞子英雄之全面开战
痞子英雄1：全面开战	痞子英雄之全面开战
无分布	妈妈别走
澳門往事	澳门往事
明清最大商帮的财富之道	大儒徽商
歌舞青春中国版	歌舞青春
唐伯虎点秋香2	唐伯虎点秋香2之四大才子
小树的夏天 LOVE MIME	小树的夏天
横财险路	一夜富贵
今日涨停	三利股份
欢乐英雄	情陷
鸿门宴	王的盛宴
近在咫尺	近在咫尺的爱恋
大醉侠	伏虎擒恶
玫瑰和他印在墙上的影子	少年
上海 蓝	上海
12生肖	十二生肖
生肖传说	十二生肖
飞鹰计划3	十二生肖
成龙计划	十二生肖
铠甲勇士	铠甲勇士之帝皇侠
铠甲勇士之皇帝侠	铠甲勇士之帝皇侠
畫皮Ⅱ	画皮2
转生术(台)	画皮2
画皮II	画皮2
移动城市：致命引擎(港	掠食城市
台)	掠食城市
牵引城市	掠食城市
致命引擎	掠食城市
掠食城市：致命引擎	掠食城市
星原战记	太空历险记
风花雪月	一场风花雪月的事
汶川纪录片：为了生命	为了生命
侠侣探案	侠侣探案系列之古刹怪佛
抱抱俏佳人	完美嫁衣
败犬多情	完美嫁衣
凹凸情人	完美嫁衣
不省心	非诚勿扰2
三言二拍之毒中毒	毒中毒
三言两拍之珍珠衫	珍珠衫
舞潮	舞女
巴颜喀拉的雪	喇叭裤飘荡在一九八三
追赶太阳的人	追赶太阳的人们
热血黄昏	如血黄昏
黑色河流	眷恋
財神到	财神到
台风	云娜
黑猫警长	黑猫警长电影版
黑猫警长2010电影版	黑猫警长电影版
戀愛達人	恋爱达人
开国元勋的夫人们	忠贞
爱情三十六计	爱情36计
摇摆的婚约	摇摆de婚约
玩转大明星	恋爱通告
財神客棧	财神客栈
我的天空	爱出色
留守童年	守护童年
新版大力水手	大力水手
大力水手 2013	大力水手
向快乐出发	新来的李老师
人狗奇缘2	心心历险记
美丽人生	不再让你孤单
夢の壁	梦墙
雨打芭蕉	古镇情缘
燃2	燃2之铁三角
儿子、媳妇和老娘	儿子媳妇和老娘
英雄少年赖宁	赖宁
子夜闪光	真凶疑云
白桦树的眼睛	腊月雪
诸子百家新年特别版	秦时明月之一舞倾城
五年级四班	孩子那些事儿
孩子那些事	孩子那些事儿
魁拔	魁拔之十万火急
我愛湖人	我爱湖人
欲望之街	欲望之途
爱·给予	恍若人生
爱心树	恍若人生
守望者	守望者：罪恶迷途
迷失的刀郎(豆友译名)	关云长
北纬31度的录像带	北纬31°录像带
武林外传电影版	武林外传
阿拉甲	阿拉甲神灯
历程	美的历程
上海世博中国馆主展影片	美的历程
常德大血战	喋血孤城
卫战	喋血孤城
意大利·佛罗伦萨 Tour Around The World  Florence-Italy	环游世界
寰宇地理之战争启示录	寰宇地理之二战启示录
撒谎的村庄	宝贵的秘密
荒原惊情	惊情
大型音乐舞蹈史诗电影《复兴之路》	复兴之路
-  天然地貌博物馆	龙门山
魔术外传	最爱
魔术时代	最爱
罪爱	最爱
武林笑传	嘻游记
纪录片《老族谱》	老族谱
索达吉堪布放生纪行	慈悲之旅
芳心大盗	我知女人心
萨维奇博士	奇兵勇士
社区民警的故事	我在胡同当片警
东方的承诺2	尸体交错
大汉风之大风起兮	大风起兮
上海滩之新报仇	新报仇
三国·荆州	影
荆州保卫战	影
黄了一个来月(豆友译名)	失恋33天
撒娇的女人最好命	撒娇女人最好命
会撒娇的女人最好命	撒娇女人最好命
母狗	花
婊子	花
潇洒走一回	顽皮小子历险记
廬山風雲	庐山风云
旧照片	川川和洋洋
北京深秋的故事	燃烧的欲望
蔡李佛拳2010	蔡李佛拳
将爱 电影版	将爱情进行到底
对你爱爱爱不完(豆友取名)	将爱情进行到底
水浒人物谱之母大虫顾大嫂	母大虫顾大嫂
我们曾经的秘密基地	忘了吗，我们曾经的秘密基地
世博冠军湖丝仔	世博总动员
谁说玻璃不是镜子	你是我的谁呀
抗战三部曲第二部之岁岁清明	岁岁清明
静电影《初见》篇章一《停滞的时光》	初见：停滞的时光
大魔術師	大魔术师
天仙奇缘	大话天仙
春天关不住	传真女孩
80后	无痛
李小龙	李小龙我的兄弟
少年李小龙	李小龙我的兄弟
李小龙，我的兄弟	李小龙我的兄弟
硬汉之爱情保卫战	硬汉2：奉陪到底
西游新传：大电影	西游新传
玩家一号	头号玩家
挑战者1号(港)	头号玩家
一级玩家(台)	头号玩家
一号玩家	头号玩家
其后 After All These Years	其后
他说爱	激浪青春
飞跃绝境	飞越绝境
举起手来（之二）：追击阿多丸	举起手来2：追击阿多丸号
媚影俠蹤	媚影侠踪
第五次元(港)	时间的皱折
时间的皱纹	时间的皱折
奇幻时空历险	时间的皱折
梅格时空大冒险	时间的皱折
手拉手	我们手拉手
玩命·时光	玩命时光
同谋者	武侠
法海:白蛇传说(台)	白蛇传说
白蛇传说之法海(港)	白蛇传说
‎法海	白蛇传说
草原小英雄	巴特拉尔传说
春滋味	大劫难
十一朵鲜花	我11
我十一	我11
奋斗 电影版	奋斗
奋斗2011	奋斗
麵引子	面引子
新康定情歌	康定情歌
如烟往事	幻影
飞行器	梦幻飞琴
黃埔軍魂	黄埔军魂
晶体Ⅱ	晶体2
功夫咏春	功夫·咏春
最强喜事	最强囍事
流光速	极速天使
剩男剩女	缘来是咱俩
倮恋	倮·恋
静电影《初见》篇章二《子非鱼》	初见：子非鱼
异度危情	异空危情
燃情世界杯	追踪章鱼保罗
谋杀章鱼保罗	追踪章鱼保罗
兩個女孩一間房	魔法迷失
恋爱吧	跟我的前妻谈恋爱
翻叮我老婆	跟我的前妻谈恋爱
泡芙小姐的金鱼缸	11度青春之《泡芙小姐的金鱼缸》
楚汉争霸	西楚霸王II
西楚霸王II	西楚霸王II
西楚霸王下	西楚霸王II
芦笛舞曲	首席
决不言弃	幸存日
投篮者	特别的爱
少女时代	我的少女时代
波希米亚狂想曲(台)	波西米亚狂想曲
波希米亚狂想曲：摇滚传说(港)	波西米亚狂想曲
大宅门 电影版	大宅门
西游·降魔篇	西游降魔篇
大话西游之除魔传奇	西游降魔篇
除魔传奇	西游降魔篇
三藏伏魔	西游降魔篇
西游	西游降魔篇
风流奇侠	龙朝凤
谍战揭密：十九集大型历史纪录片	纪实：档案--谍战揭密
人间草木—打一字	人间草木
大闹天宫3D版	西游记之大闹天宫
守兵衛	守兵卫
未来战士	守兵卫
超音速刑警	车手
美丽谎言(港)	幸福卡片
三十三张明信片	幸福卡片
第十三号子弹	13号子弹
天劫：救赎之战(台)	天际浩劫2
天凶之城：末日救赎(港)	天际浩劫2
当福音再临(台)	到来的主日
镖行天下前传3	镖行天下前传之库丁之谜
北魏传奇之悲情英雄	北魏传奇
胡笳汉月	北魏传奇
北魏传奇1	北魏传奇
无极限	无极限之危情速递
兔侠	兔侠传奇
决战浦东·1949	铁血奇兵
北魏传奇之爱归五胡沧海情	北魏传奇之4
水浒人物谱之杨雄与石秀	杨雄与石秀
醒世恒言之黄秀才徼灵玉马坠	玉马坠
侠侣探案系列杜鹃啼血	侠侣探案系列之杜鹃啼血
侠侣探案系列名苑斜阳	侠侣探案系列之名苑斜阳
侠侣探案系列绝命黄历	侠侣探案系列之绝命黄历
侠侣探案2	侠侣探案系列之书生之死
侠侣探案之商女梦断	侠侣探案系列之商女梦断
侠侣探案8	侠侣探案系列之特使失踪
秘密人：今日我下机关，明日我上天曹	秘密人
车站	車站
机械城堡,一个魔方引起的故事	机械迷城
侠侣探案1	侠侣探案系列之寿筵丧钟
一月的追踪者	小城之冬
宅男总动员：女神归来	宅男总动员
宅男女神	宅男总动员
沙门空海	妖猫传
沙门空海之大唐鬼宴	妖猫传
大唐鬼宴	妖猫传
空海	妖猫传
空海 KU-KAI 美しき王妃の謎	妖猫传
沙門空海唐の国にて鬼と宴す	妖猫传
如果	爱
爱情不在服务区	爱
侠侣探案3	侠侣探案系列之晓风残月
掐死你的温柔	火药牌女友
大学哭过 笑过	那时的他们
笑过，哭过，我们都经历过	那时的他们
镖行天下前传2	镖行天下前传之至尊国宝
镖行天下前传5	镖行天之前传之漠上风云
镖行天下前传4	镖行天下前传之虎口夺镖
镖行天下前传7	镖行天下前传之编外人选
镖行天下前传6	镖行天下前传之燃眉危机
镖行天下前传之烽火三千里	镖行天下前传之烽火辽东
镖行天下前传之亡命天涯	镖行天下前传之决战天涯
大汉风之英雄美人	英雄美人
天机(港)	天机·富春山居图
富春山居图	天机·富春山居图
喜羊羊与灰太狼3	喜羊羊与灰太狼之兔年顶呱呱
亡命琴师	命系琴弦
西京囧事	哥的传说
回忆之前忘记之后	回忆之前，忘记之后
老夫子	老夫子之小水虎传奇
《大笑江湖》纪录片	江湖啊江湖
国产雪蛤威龙	霹雳神鹰
钢琴密码	钢琴木马
钢琴密码之骇客公敌	钢琴木马
草莓100%	草莓百分百
操盘风云2	窃听风云2
我与我的影子	我和我的影子
震撼擂台(台)	铁拳
再战击情(港)	铁拳
左撇子	铁拳
离骚II：A Personal Statement of Growth	离骚II：关于成长的个人陈述
热恋岛	热爱岛
鸿门宴	鸿门宴传奇
童话	都市童话
乘着歌声的翅膀	歌声的翅膀
黑客帝国3.0	黑客悲情
与妻书	百年情书
王牌巨猩(台)	大明猩
超级巨猩(港)	大明猩
棒球明猩	大明猩
女生日记	清青年华
21红色名单	亲恩国仇
寒假不冷	老妈你真烦
胡力吐	沉默的荣誉
山边那朵云	天边的云
密室2	密室之不可靠岸
聊斋。侠女	侠女
卡酷动画春晚	2011BTV卡酷动画春晚
英雄血	歧路英雄
說好不管我	说好不管我
水浒人物谱之入云龙公孙胜	入云龙公孙胜
the summer（英）	被风吹过的夏天
冠军宝贝之无价之宝	无价之宝
举起手来三部曲之一	飞虎群英
高海拔之恋2	高海拔之恋Ⅱ
如果遇见 Shutter Love	如果遇见
如果见，请深见...	如果遇见
水浒人物谱之鼓上蚤时迁	鼓上蚤时迁
水浒人物谱之神偷时迁	鼓上蚤时迁
神偷时迁	鼓上蚤时迁
杨贵妃	王朝的女人·杨贵妃
盛唐危机	王朝的女人·杨贵妃
一门忠烈杨家将	忠烈杨家将
杨家将	忠烈杨家将
太极	太极1：从零开始
太极之从零开始	太极1：从零开始
狄仁杰前传	狄仁杰之神都龙王
虎头要塞：细菌	虎头要塞之细菌
国父孙中山	第一大总统
谋士范增	大汉风之谋士范增
石溪三部曲之三不如归去	不如归去
红风筝	明天我要升国旗
日照512	日照好人
温故1942	一九四二
温故一九四二	一九四二
厨戏痞	厨子戏子痞子
厨子·戏子·痞子	厨子戏子痞子
虎烈拉	厨子戏子痞子
超蛙战士	超蛙战士之威武教官
被遗忘的水彩画	蜡笔和小新的故事
蔡李佛：极限拳速	蔡李佛
蔡李佛：铁拳2010	蔡李佛
相隔一座城	电话厅情缘
饮食男女2012	饮食男女-好远又好近
好近又好远	饮食男女-好远又好近
从今以后(2002)	从今以后
赛尔号	赛尔号大电影之寻找凤凰神兽
赛尔号大电影：寻找凤凰神兽	赛尔号大电影之寻找凤凰神兽
甲午大海战	一八九四·甲午大海战
1894·甲午大海战	一八九四·甲午大海战
黄金谜案	黄金大劫案
濠河女人	濠河边上的女人
鸣沙山	大漠追艳
黑风血雨	我的爱对你说
妈妈没走远	妈妈没有走远
成都的冬天不太冷	情遇成都
时尚达人	与时尚同居
戈蒂传	高蒂传
约翰·高蒂的生与死	高蒂传
高蒂家族：父影之下	高蒂传
高蒂：三代人	高蒂传
雅痞教父高蒂一家人	高蒂传
边城往事	乌鲁木齐的天空
三十七号大院	乌鲁木齐的天空
同一屋檐下	乌鲁木齐的天空
乌鲁木齐	乌鲁木齐的天空
水中的恋人	摆手舞之恋
夜店鬼谈	夜店诡谈
夜店怪谈	夜店诡谈
阿曼尼莎罕	阿曼尼萨罕
你以为你是谁	家事
光辉岁月之再见理想	岁月无声
随子弹去	一步之遥
追踪1921	沪上风云
地下爱情	野草莓
惊悚之夜	水落石出
回家	民工回家
在路上	我在路上最爱你
三日三夜	我在路上最爱你
DV 爱情 夏天	DV·爱情·夏天
自由ヶ丘	自由之丘
雨一直下	新妈妈再爱我一次
命运讯号	昆明讯号
虫虫幻想曲	亲亲我
贞观家事	三哭殿
我电你	爱封了
少林寺之佛魔之间	佛魔之剑
票风	飘
春嬌與志明	春娇与志明
志明与春娇2	春娇与志明
黑社会太美丽	给野兽献花
西柏坡的故事	西柏坡
有诚可扰-纪念我们心中那个红裙姑娘	有诚可扰
热血传奇	赛车传奇
虎头要塞：图纸	虎头要塞之图纸
再别故乡	离离旧忆
東京に来たばかり	初到东京
虎头要塞：假如明天来临	虎头要塞之假如明天来临
虎头要塞：谎言	虎头要塞之谎言
虎头要塞：蓝色七号	虎头要塞之蓝色七号
影子愛人	影子爱人
影子情人	影子爱人
再说一次我爱你	影子爱人
虎头要塞：最后决战	虎头要塞之最后决战
离骚3：Sweets and Pains	离骚终结篇
虎头要塞：牺牲	虎头要塞之牺牲
贾晋蜀	人民艺术家
上海1925	先驱者
黄金岛	北角
夏日么么茶2	夏日乐悠悠
领袖情怀	情怀
文建明	头等大事
爱·不爱	一夜未了情
洛克王国！圣龙骑士	洛克王国之圣龙骑士
潜舰猎杀令(台)	冰海陷落
猎人杀手	冰海陷落
飞毛腿的夏天	足球小子飞毛腿
关爱——严冬里的春天	严冬里的春天
严冬里的春天之人间有情+严冬里的春天之情归何处	严冬里的春天
凯撒音乐电影	凯撒
明日に架ける愛	通往明日之爱
架向明天的爱	通往明日之爱
通往明日的爱	通往明日之爱
五道弯	紫石峪
共和国名将·刘昌毅决战宿县	刘昌毅决战宿县
白衣将军孙仪之	四平保卫战中的白衣将军孙仪之
假如我是你	变身男女
共和国名将·杨勇战鲁西	杨勇战鲁西
李逵传奇	黑旋风李逵
水浒人物谱之晁盖	晁盖
水浒人物谱之鬼脸儿杜兴	鬼脸儿杜兴
水浒人物谱之安道全与王定六	安道全与王定六
明月	明月在心
观觉寺	月夜观觉寺
秦时明月3D电影龙腾万里	秦时明月之龙腾万里
秦时明月大电影之龙腾万里	秦时明月之龙腾万里
断了片	醉后一夜
良家妇女被枪记(豆友译名)	许鏐抢亲记
软件，我爱你	如果
极峰迷情	命运有数
愛	爱
狂奔的蚂蚁	狂奔蚂蚁
疯狂的蚂蚁	狂奔蚂蚁
重庆 音乐	吴昊昊
子弹情人	子弹情侣
说你爱我	有人拉屋米
好汉花龙	好汉花荣
海洋大队	海鲜陆战队
海鲜	海鲜陆战队
朱莉的陆地大冒险	海鲜陆战队
极恋	东极之恋
英雄·喋血	英雄喋血
女蛹之人皮嫁衣	女蛹
丢失的学生证	四年一梦
新地道战2之父子奇兵	新地道战2
水浒人物谱之赤发鬼刘唐	赤发鬼刘唐
双殊泪	双姝血案
芙蓉雀	夫仇记
迷宅	替身情缘
檀香谜案	檀香迷案
王刚讲故事之千金绑架案	千金绑架案
灰姑娘	宋朝灰姑娘
烟雨俚歌	芦花寨
双生花	残梦
一天的英雄	364天
“美蒋特务”孙水胤的后现代生活	特务孙水胤的后现代生活
三言二拍之金玉奴	金玉奴
闯堂兔大电影	闯堂兔
五星上将	铁血娇娃
铁血娇娃之丛林日记	铁血娇娃
男女关系之密语(台)	母语
我叫小马	幸福59厘米之小马
跑酷：战胜你的恐惧	极速先锋
3D极速先锋	极速先锋
穿透高墙的阳光	警戒线
别闹，改日	幸福59厘米之别闹，改日
孔庆德护送卡尔逊	孔庆德生死护送卡尔逊
疯狂老人院	飞越老人院
乔迁之喜	房不胜防
八星报喜2012	八星抱喜
家有喜事2012	八星抱喜
新八星报喜	八星抱喜
美国特工(港)	美国刺客
裸爱杀机(台)	丽兹
丽兹·波顿	丽兹
梦断影都	游坞惊梦
月光井	女人如花
绝恋	女人如花
2次曝光	二次曝光
兔子镇的火狐狸之狐狸特工	兔子镇的火狐狸
第一季	微博有鬼
微博有鬼I	微博有鬼
冬天里的绿萝花	合居情缘
长城外面是故乡	追爱
帮我找到张秀倩	追爱
寒戰	寒战
Cold War 香港警察 两种正义(日)	寒战
海岛乐园	请叫我英雄
情归延安	窑洞小学
上善若水2你在哪里	你在哪里
炼狱里的阳光	阳光总在风雨后
柠檬缘	柠檬
知了的夏天	原谅我，来不及爱你
陇南往事	两当兵变
寶島雙雄	宝岛双雄
大武当	大武当之天地密码
霹靂戰士	霹雳战士
青春期2	青春失乐园
同桌的你	不羁的青春
我们的从前	不羁的青春
温哥华乐与路	温哥华酱油乐队
美国城	纽约客@上海
致青春	致我们终将逝去的青春
冰封侠：重生之门(港)	冰封：重生之门
急冻行者(台)	冰封：重生之门
3D冰封侠	冰封：重生之门
少年岳飞	自古英雄出少年之岳飞
纯真时代	纯真年代
非常完美2	非常幸运
情謎	情谜
孪爱	情谜
卵と石	鸡蛋和石头
奇案风云之消失的子弹	消失的子弹
暴力营救	危情营救
虎穴	不再沉睡
衝上雲霄	冲上云霄
冲上云霄电影版	冲上云霄
花漾：盗伎传奇	花漾
蓝色七星湖	蓝色的七星湖
魁拔II	魁拔之大战元泱界
魁拔2	魁拔之大战元泱界
一個女工的故事	一个女工的故事
守诛人	守株人
前任告急	房车奇遇
变形金刚：歼灭世纪(港)	变形金刚4：绝迹重生
变形金刚4：灭绝时代	变形金刚4：绝迹重生
变形金刚4	变形金刚4：绝迹重生
变4	变形金刚4：绝迹重生
济南路8号	绝录求生
喜羊羊与灰太狼4	喜羊羊与灰太狼之开心闯龙年
疾速救援(台)	通勤营救
追命列车(港)	通勤营救
水浒人物谱之双鞭呼延灼	双鞭呼延灼
2012我愛HK 喜上加囍	2012喜上加喜
我爱香港2	2012喜上加喜
我爱香港救地球	2012喜上加喜
箭客柳白猿	箭士柳白猿
毒戰	毒战
破冰	毒战
春天花会开	魂系红领巾
涩女郎电影版：男生女生骗	粉红女郎之爱人快跑
粉红女郎电影版	粉红女郎之爱人快跑
金童玉女	绝命藏宝图
阿兰	墨香天使
武當少年	武当少年
梦幻童年	武当少年
谜	浮城谜事
侏罗纪公园4	侏罗纪世界
冯友兰	青年冯友兰
3D诡婚	诡婚
重归大海	重返大海
战争巫师	战争魔术师
麻局	局中局
当孙悟空遇上蜘蛛侠	孙子从美国来
海上情谜(台)	秘密分享者
谎言荒原	猪离开了它的外套
盗中道	疯狂的蠢贼
阿里郎	平壤之约
冷瞳·贞子再现	冷瞳
给你点儿颜色	关于爱情和那些魔鬼
泊車殿下	泊车殿下
蓝雪花	迷失的精灵
迷失	迷失的精灵
双节棍	双截棍
诸事不宜	四戒
匹夫们的战争	匹夫
匹夫有责	匹夫
水浒人物谱之金毛犬段景住	金毛犬段景住
女留学生之迷失废都	家庭计划
五指山之恋	我爱五指山
何班主与他的情人	何班主和他的情人
千里渡江第一船	渡江！渡江！
渡江渡江	渡江！渡江！
百万巨鳄追缉令	百万巨鳄
抗美援朝	北纬三十八度
中国1949	中国·1949
中国——1949	中国·1949
局外人	外来者
风水	万箭穿心
一代跤王	宗师卜六
少年侯德榜传奇	少年侯德榜
美版大逃杀	大逃杀(美版)
诡先生	怖偶
爱，回家	都市有情天
穿过爱情的漫长旅程	黄金时代
萧红传	黄金时代
吉星厨神(港)	花样厨神
厨房故事	花样厨神
XX计划	X计划2
非常之戀	非常之恋
非常盗	月色狰狞
廢棄之城	废弃之城
孙立智取祝家庄	病尉迟孙立
水浒人物谱之病尉迟孙立	病尉迟孙立
擒爱记：回收女人心	擒爱记
熟女日记	擒爱记
盛开的向日葵	幸福的向日葵
亲爱	亲·爱
相信爱	初恋浅规则
幸福	幸福迷途
聊斋狐仙	狐仙
太极2	太极2：英雄崛起
太极之英雄崛起	太极2：英雄崛起
美丽有缘	北京遇上西雅图
情定西雅图	北京遇上西雅图
泰囧	人再囧途之泰囧
人在囧途2	人再囧途之泰囧
组织部长	公道天职
燃3	燃3之燃烧殆尽的青春
喜羊羊与灰太狼暑期大电影	我爱灰太狼
喜羊羊与灰太狼真人大电影	我爱灰太狼
文字国历险记：浩昊大闹文字城	文字国历险记之浩昊大闹文字城
高高的瞭望塔	老哨卡
北纬52度	老哨卡
今天明天	今天·明天
浮城	浮城大亨
百年浮城	浮城大亨
罗布泊	生死罗布泊
美丽不瘦	瘦身魔方之美丽不瘦
我和拉拉	我与拉拉
猪猪侠大电影	猪猪侠之囧囧危机
劫假日	地域无门
控城计	控制
空城计	控制
惡戰	恶战
上海滩马永贞	恶战
四大名捕3	四大名捕大结局
下集	上海滩
贵族	私人订制
男人如衣	男人如衣服
同謀	同谋
A+侦探	同谋
私奔	稍安勿躁
突袭美版	突袭
影子国王	影子之王
摩尔庄园2	摩尔庄园2海妖宝藏
标奇立艺	中国当代艺术
职业特工队5：叛逆帝国(港)	碟中谍5：神秘国度
不可能的任务：失控国度(台)	碟中谍5：神秘国度
碟中谍：失控国度	碟中谍5：神秘国度
碟中谍5	碟中谍5：神秘国度
爆裂功夫	龙拳
勇士	神勇投弹手
昂仁	仲巴
郑和1405	郑和1405：魔海寻踪
郑和·魔海劫	郑和1405：魔海寻踪
@在一起	在一起
侦缉蜜语	在一起
影子富豪	做次有钱人
狂恋	执迷
铸剑1927	忠诚与背叛
石器时代	石器时代之百万大侦探
传奇	史前怪兽
传·奇	史前怪兽
007之父	未定名弗莱明传记片
魔钟奇幻屋(港)	滴答屋
墙上有一个钟的房子	滴答屋
墙里有钟的房子	滴答屋
甜蜜十八岁	甜蜜18岁
美好2012之春暖花开	春暖花开
逃出生天3D	逃出生天
火痛	逃出生天
掃毒	扫毒
变役	扫毒
野人牛牛女	暴走吧，女人
麥兜‧噹噹伴我心	麦兜·当当伴我心
腰花伴菜芯	麦兜·当当伴我心
麦兜故事5	麦兜·当当伴我心
地下十八层	电梯惊魂
画圣吴道子	画圣
吴道子	画圣
容颜	爱，不能没有你
公子多情	爱爱囧事
恋爱囧事	爱爱囧事
父子神探（第七部）	父子神探之滴血的戒指
父子神探（第六部）	父子神探之燕子窠迷案
葉問：終極一戰	叶问：终极一战
叶问终极篇之香江岁月	叶问：终极一战
北魏传奇6	北魏传奇之宏图恨
赛尔号2：雷伊与迈尔斯	赛尔号大电影2之雷伊与迈尔斯
赛尔号大电影2：雷伊与迈尔斯	赛尔号大电影2之雷伊与迈尔斯
潜江红	虾哥的故事
陌生	忘了去懂你
智取威虎山3D	智取威虎山
林海雪原3D	智取威虎山
白发魔女传3D	白发魔女传之明月天国
冰雪十一天	冰雪11天
西藏的天空	西藏天空
路花	线索
超越潜能(港)	超验骇客
全面进化(台)	超验骇客
超越	超验骇客
血色战神	绝无退路
虎啸南天	绝无退路
爱情部落之婚姻指南	爱谁谁
拐杖老师	拐杖
绑架对门狗	搞定对门狗
双骏传奇	国宝疑云
18亿红线	十八亿红线
危城	危城之恋
铁蛋儿的情歌	美姐
幸福旅行团	等风来
天台	天台爱情
我们的歌	初恋未满
歌的神	初恋未满
钝秀才	蹉跎行
水浒人物谱之金枪手徐宁	金枪手徐宁
安庆喋血	刺夜
龙之谷之黑龙崛起	龙之谷：破晓奇兵
龙之谷大电影	龙之谷：破晓奇兵
龙之谷前传	龙之谷：破晓奇兵
水浒人物谱之菜园子张青	菜园子张青
幸福三角地	三角地
e恋迷情	地下室惊魂
邋遢大王奇遇记 影院版	邋遢大王奇遇记
微电影《美丽》	美丽
L剧美丽	美丽
王子的吻	小胖妞前传（上）
大兵小将系列大兵金宝历险记	大兵金宝历险记
妙姗之异境巴黎	妙之异境巴黎
名模	我的美丽王国
刺客教条(港	刺客信条
台)	刺客信条
海阔天空(台)	中国合伙人
三个中国先生	中国合伙人
中国先生	中国合伙人
荷都奇遇	荷都之恋
刘海粟	叛逆大师刘海粟的故事
十二星座发财梦之猎音师	猎音师
惊梦	无声情人
万有坏力	蓝鲸过度放松
水浒人物谱之小旋风柴进	小旋风柴进
拼车惊情	诡拼车
目擊者	目击者之追凶
水浒人物谱之玉麒麟卢俊义	玉麒麟卢俊义
致敬青春：致我们终将逝去的青春！	致敬青春
快乐大本营之快乐到家	快乐到家
快乐到家之百万宝贝	快乐到家
无间罪	无间罪：僵尸重生
我不是傻瓜	我的影子在奔跑
吃记忆的大雪球	宝贝女儿好妈妈之吃记忆的大雪球
宝贝女儿好妈妈大电影	宝贝女儿好妈妈之吃记忆的大雪球
賭城風雲	澳门风云
赌神4：谁与争锋	澳门风云
八七会议	风云1927
江岸风云	风云1927
神獸巴打	刑警兄弟
神兽刑警	刑警兄弟
啊！朋友还钱	啊朋友还钱
毛遂传奇	毛遂自荐
扎西大转折	扎西1935
雷锋的美丽年华	青春雷锋
永远的雪山草地	走过雪山草地
星光璀璨的夏天	晚安·夏
追你在天边	追你到天边
工会主席	咱们的工会主席
借你俩胆儿	借你俩胆
生死守望	绿色的梦
别和我谈高富帅	别跟我谈高富帅
旅行也会开花	别跟我谈高富帅
我想有一个梦	我想有个梦
早见晚爱	早见，晚爱
西施 2011	西施
華麗上班族	华丽上班族
华丽上班族之生活与生存	华丽上班族
软柿子	原谅我的青春
向阳坡	向阳坡传说
老司机	爱情的士
草食动物殉难记	兔爷狂想曲
黄山	时光的旅行
疯狂漂移假爸爸	疯狂飘移假爸爸
假爸爸	疯狂飘移假爸爸
分手速递	因情圆缺1：分手速递
窒命替身	致命替身
致命·替身	致命替身
海澜	梦幻岛
孤膽少年	孤胆少年
钗头凤	沈园情
姐妹排	杜鹃花飞
水浒人物谱之铁面孔目裴宣	铁面孔目裴宣
巫山的红	她们的名字叫红
她们的名字叫做红	她们的名字叫红
飞行公路	一克拉梦想之飞行公路
黒い四角	黑四角
黑方块	黑四角
茶香三部曲之咫尺	咫尺
DZMZ大自鸣钟2作家	大自鸣钟2作家
红芦苇	一江明烛
路在远方	路的远方
两情双月	夏日示爱
茶香三部曲之回家	回家
爱，很美	爱很美
美丽的背后	爱很美
青蛙王国之我嘞个去	青蛙王国
骊靬情	罗西与莫妮卡之骊靬情
罗西与莫妮卡	罗西与莫妮卡之骊靬情
沙湖沔阳州	沔阳一九一一
沔阳1911	沔阳一九一一
爱神来了	爱神
鱼和它之恋	鮀·恋
鮀恋	鮀·恋
养蟹人	蟹王
吴裕泰茶香三部曲之集合	集合
弹无虚发之风戈壁	弹无虚发之深藏不露
弹无虚发之夺命童谣	弹无虚发之深藏不露
磨剪子戗菜刀	磨剪子抢菜刀
那些花儿	那朵花儿
9号公路	九号公路
忠义侠	周仁回府
鸳鸯泪	周仁回府
成吉思汗的十个勇士	阿尔巴特
十户	阿尔巴特
十勇士	阿尔巴特
父子神探（第八部）	父子神探之龙抬头
金刚王	金刚王：死亡救赎
电影版小小飞虎队	小小飞虎队
小小飞虎队金龙版	小小飞虎队
西柏坡2·英雄王二小	西柏坡2：英雄王二小
阿米走步	阿米·走步
朋友！朋友！	阿米·走步
1932·马迭尔风云	远东一九三二（下）风云马迭尔
远东一九三二之风云马迭尔	远东一九三二（下）风云马迭尔
今日我出警	今天我出警
亲人	咱们是亲人
青苹果	姑娘
黑飘带	白手绢
刑警张玉贵的队长生活	刑警张玉贵之队长生活
刑警张玉贵第二部	刑警张玉贵之队长生活
刑警张玉贵2	刑警张玉贵之队长生活
刑警张玉贵第三部	刑警张玉贵之三：执法者
刑警张玉贵3	刑警张玉贵之三：执法者
刑警张玉贵第四部	刑警张玉贵之四：忠孝两全
刑警张玉贵4	刑警张玉贵之四：忠孝两全
末日之恋	逐爱之旅
绝命逃亡	白幽灵传奇之绝命逃亡
最后的战争	白幽灵传奇之绝命逃亡
驱逐者	白幽灵传奇之绝命逃亡
驱逐之人	白幽灵传奇之绝命逃亡
超級經理人	超级经纪人
七年	爱呦，阿斗
李豁子的婚事	李祥和的婚事
乡村女教师	望月
吕梁铁血	吕梁铁骨
虎头要塞：一封没有发出的信	虎头要塞之一封没有发出的信
虎头要塞：舌头	虎头要塞之舌头
烂猫	猫烂
爱在云端	彼端
海神003	海神密码
玩不起	三人床
有一种爱	有一种爱叫做放手
李豁子离婚	有一种爱叫做放手
喜羊羊与灰太狼大电影5	喜羊羊与灰太狼之喜气羊羊过蛇年
喜羊羊与灰太狼之冒险蛇年传	喜羊羊与灰太狼之喜气羊羊过蛇年
喜羊羊与灰太狼5	喜羊羊与灰太狼之喜气羊羊过蛇年
曖	暧
愛你的我	暧
冰裸杀(港)	制服
恶魔右手	制服
红眼睛	制服
瘟泉	人间蒸发
觀世音菩薩的故事	观世音菩萨的故事
观世音菩萨授记经	观世音菩萨的故事
不眴太子	观世音菩萨的故事
童子发愿	观世音菩萨的故事
观世音菩萨普门品	观世音菩萨的故事
六字大明陀罗尼的故事	观世音菩萨的故事
大悲心陀罗尼的故事	观世音菩萨的故事
北京纯爱故事	那一天
暴雨将至	梦想就在身边
鼓岭故事	梦中鼓岭
七夜惊魂	异度迷局
巴啦啦小魔仙大电影	巴啦啦小魔仙
小时代1.0折纸时代	小时代
小时代电影版	小时代
猛龍特警之天羅地網	猛龙特警之天罗地网
新警察故事之人间有情	猛龙特警之天罗地网
爱的季节	回到爱开始的地方
宫电影版	宫锁沉香
爱与失落	爱迷失
小和尚大当家之智斗三笨贼	小和尚大当家
Come on！汪星人	金牌流浪狗
風暴	风暴
激戰	激战
激战：勇者不败(台)	激战
激战MMA	激战
怒放	怒放之青春再见
怒放青春	怒放之青春再见
怒放2013	怒放之青春再见
蒲怨	血彩
越来越好·村晚	越来越好之村晚
乐山爱	乐山·爱
夺宝幸运星大电影之金箍棒传奇	金箍棒传奇
开心西游记	金箍棒传奇
追影子的人	逐影
青春2013	青春
摄影师的秘密	摄影师
小企鹅波鲁鲁之冰雪世界赛车冒险记	波鲁鲁冰雪大冒险
大禹	华夏之王
一个人的战争	私人战争
请你相信我	凭啥相信你
山之巅(原著) ； Mr.Liu's Marragies(英语译名)	老刘的婚路历程
工体爱情故事	谁说我们不会爱
父亲朱邦月	为爱而来
父亲	为爱而来
最后一次说爱你	爱情时光机
天堂的午餐	天堂午餐
妈妈，我爱您(港)	我的狗狗我的爱
我和狗狗有个约会	我的狗狗我的爱
妙狗仁心	我的狗狗我的爱
水浒人物谱之大刀关胜	大刀关胜
大侠关胜	大刀关胜
水浒人物谱之旱地忽律朱贵	旱地忽律朱贵
水浒人物谱之神算子蒋敬	神算子蒋敬
绝对搭档之滑雪场事件	绝对搭档
雪地疑案	绝对搭档
环太平洋2	环太平洋：雷霆再起
环太平洋2：雷霆再起	环太平洋：雷霆再起
环太平洋2：起义时刻(台)	环太平洋：雷霆再起
悍战太平洋2：起义时空(港)	环太平洋：雷霆再起
环太平洋2：崛起	环太平洋：雷霆再起
环太平洋2：漩涡	环太平洋：雷霆再起
颍河岸边的春天	颍河岸畔的春天
力王之真正的敵人	力王之真正敌人
交换之旅	交换旅行
雾里看花	柏拉图之梦
无敌破坏王2	无敌破坏王2：大闹互联网
无敌破坏王2：网路大暴走(台)	无敌破坏王2：大闹互联网
无敌破坏王2：打爆互联网(港)	无敌破坏王2：大闹互联网
无敌破坏王2：破坏王大闹互联网	无敌破坏王2：大闹互联网
特种救援英雄	救火英雄
洛克王国大电影2	洛克王国2：圣龙的心愿
詭嬰	诡婴吉咪
诡眼	诡婴吉咪
夏当与亚娃	我想和你好好的
杀手梦影	海曲梦影
烟台——莫里斯	再爱一次好不好
聽見下雨的聲音	听见下雨的声音
奇迹：追踪彩虹	奇迹：追逐彩虹
城里城外	错位恋人
《萤火虫不说2：苦角》	苦角
Rush短片：逆转	逆转
我的罗马假日	新罗马假日
234說愛你	234说爱你
我心凝望的爱情	234说爱你
第四者	234说爱你
异刑	诡镇
险路勿近	诡镇
儿女传奇之民国警花	民国警花
幻想症	孤独幻者
瑪德2號	玛德2号
玛德二号	玛德2号
勇敢爱之石头剪刀布	石头剪刀布
刑警队长	警界无声
成成烽火之金戈铁马	成成烽火之浴血奋战
一触即发	猎仇者
一个导演的流产	干掉导演
山寨也疯狂	都是手机惹的祸
一号化妆间电影版	一号化妆间
致命CS	鬼马灯
九死一生 :把一切献给党	九死一生之把一切献给党
寒戰II	寒战2
寒战II	寒战2
被偷走的5年	被偷走的那五年
被偷走的时光	被偷走的那五年
最后一次说爱你	被偷走的那五年
倾城之泪2	被偷走的那五年
悲伤成河	被偷走的那五年
幽灵车库	三更车库
地下11米	三更车库
朝内81号	京城81号
智战	智战1940
闯入者*	闯入者
你要去北京	我要回桃花江
毛主席在杨家沟	杨家沟的天
軍中樂園	军中乐园
海棠花开	大山里的春天
快乐足球	圣龙奇兵大冒险
仁者天下之凤舞九天	圣龙奇兵大冒险
圣龙奇兵	圣龙奇兵大冒险
逆警	魔警
三月之恋	三月
甘祖昌将军	这样一位将军
共和国名将·傅继泽智斗泊头	傅继泽智斗泊头
霸王别姬(戏曲电影)	霸王别姬(京剧)
霸王别姬3D	霸王别姬(京剧)
霸王别姬	霸王别姬(京剧)
龙凤呈祥	龙凤呈祥(京剧)
龙凤呈祥(戏曲电影)	龙凤呈祥(京剧)
汤显祖传	梦寻
毁天灭地	黑暗入侵
明天	爱别离
鬼楼	楼
面孔	我被替换
王文良	稚子童心
北魏传奇3	北魏传奇之百草情恨
北魏传奇2	北魏传奇之风雨飘落都是爱
电影版杨光的快乐生活	杨光的快乐生活
北魏传奇5	北魏传奇之情缘
卧虎藏龙2：青冥宝剑	卧虎藏龙：青冥宝剑
卧虎藏龙Ⅱ青冥宝剑	卧虎藏龙：青冥宝剑
铁骑银瓶	卧虎藏龙：青冥宝剑
80后老爸	硬汉奶爸
慢慢爱之一日情	一日情
科洛弗档案3	科洛弗悖论
末世悖论(港)	科洛弗悖论
上帝粒子	科洛弗悖论
很久沒有敬我了妳	很久没有敬我了你
卡拉‧交响‧大乐队	很久没有敬我了你
水浒人物谱之霹雳火秦明	霹雳火秦明
清明列车	午夜火车
灵异列车	午夜火车
恋尚2013	谁动了我的梦想
奇异家族2	神秘世界历险记2
草原小屋	草原上的小屋
三少爷的剑3D	三少爷的剑
谁hold住谁	谁HOLD住谁
陆犯焉识	归来
桑桑和小貓	桑桑和小猫
那夜凌晨，我坐上了旺角開往大埔的紅VAN	那夜凌晨，我坐上了旺角开往大埔的红VAN
开往大埔的红VAN	那夜凌晨，我坐上了旺角开往大埔的红VAN
柒	一支录音笔的自白
杨妮妮和李娇娇的双重生活	杨妮妮与李娇娇的双重生活
止杀	止杀令
一言止杀	止杀令
妈妈片警	片警妈妈
單身男女II	单身男女2
水浒人物谱之金大坚与萧让	金大坚与萧让
化粧师	化妆师
昆曲电影红楼梦	红楼梦
美版我脑海中的橡皮擦	铭记之瞬
笔仙2	笔仙Ⅱ
传送门电影版	传送门
如果不能好好爱	脱轨时代
爱在耶路撒冷	脱轨时代
水浒人物谱之石将军石勇	石将军石勇
风雨日升昌	风雨日昇昌
相愛的七種設計	如果爱能设计
相爱的七种设计	如果爱能设计
我的恋爱时代	如果爱能设计
我的身上有刺青	胜利
画框女人	画框里的女人
少年英雄哪吒	哪吒传奇首部曲
启功	启功轶事
黑猫警长2：翡翠之星	黑猫警长之翡翠之星
黑猫警长2：决战“翡翠之星”	黑猫警长之翡翠之星
黑猫警长2电影版	黑猫警长之翡翠之星
怨灵人偶3D	怨灵人偶
咒丝	咒·丝
大耳朵图图电影版	大耳朵图图之美食狂想曲
大耳朵图图：美食狂想曲	大耳朵图图之美食狂想曲
杀手的保镖	王牌保镖
杀手保镖(台)	王牌保镖
保镖救杀手(港)	王牌保镖
血祭哈啰喂(港)	地狱游乐园
吓地狱(台)	地狱游乐园
深水地平线	深海浩劫
怒火地平线(台)	深海浩劫
顶包	我爸
Delete愛人	百变爱人
删除爱人	百变爱人
衝鋒戰警	冲锋战警
警长	冲锋战警
猛龍特囧	猛龙特囧
神魔	降魔传
济公	降魔传
神魔道	降魔传
黑色喜劇	黑色喜剧
十二星座发财梦之毕业这几年	毕业这几年
男欢·女爱	欢·爱
男欢女爱	欢·爱
欢爱	欢·爱
夜半奇谭之附近的人	怪谈
对方正在输入中	怪谈
爱心让我们一起舞蹈II	和梦一起飞
记忆周江疆	最美高富帅
新红河谷	爱未央
惊魂六年间	六年
别找到我	六年
野人	大脚印
这里是三里屯	这是三里屯
青春期3D剧场版	青春期4
诡影重重之封门村	封门诡影
4楼B座	4B青年之4楼B座
四楼B座	4B青年之4楼B座
终极解码	特殊身份
赛尔号3	赛尔号大电影3之战神联盟
赛尔号大电影3：战神联盟	赛尔号大电影3之战神联盟
姐十八来郎十八	保安刘十八
战逆豪情(港)	狂怒
怒火特攻队(台)	狂怒
暴怒	狂怒
少女传奇吴健雄	吴健雄
小润	一直是晴天
父子神探（第十部）	父子神探之卧雪图
父子神探（第九部）	父子神探之雨夜迷踪
骡子的1万米	骡子的10000米
火线追凶之不白之冤	火线追凶2之不白之冤
火线追凶之致命线人	火线追凶2之致命线人
火线追凶之乱世残局	火线追凶2之乱世残局
火线追凶之押解惊魂	火线追凶2之押解惊魂
狂野时速7(港)	速度与激情7
玩命关头7(台)	速度与激情7
圣诞怪怪杰(港)	绿毛怪格林奇
鬼灵精(台)	绿毛怪格林奇
圣诞怪杰	绿毛怪格林奇
苏斯博士的圣诞怪杰	绿毛怪格林奇
殺破狼2	杀破狼2
杀破狼2之杀无赦	杀破狼2
魔力一点点	摩登年代
欧了大卫	摩登年代
魔力万丈	摩登年代
情戒	情·戒
爱情博弈	放手爱
昆塔三部曲之盒子总动员	昆塔：盒子总动员
开心宝贝大电影	开心超人
马尔代夫遇见爱	马尔代夫遇贱爱
梅园岁月	一号目标
老人与枪	老人和枪
无缘无故	一路狂奔
铠甲勇士电影版	铠甲勇士之雅塔莱斯
铠甲勇士雅塔莱斯	铠甲勇士之雅塔莱斯
飞来鸿福	我们的安娜
勇敢游戏	时光恋人
盗梦1949	时光恋人
秦腔《海瑞驯虎》	海瑞驯虎
火线追凶之污点证人	火线追凶2之夺命书院
盂蘭神功	盂兰神功
格蕾塔	遗孀秘闻
寡妇	遗孀秘闻
跨境追捕	绝地逃亡
跳跃追踪	绝地逃亡
记得少年那首歌1969	记得少年那首歌
少年时光	记得少年那首歌
让爱回家	爱·回家
十分梦想微电影之红豆花开	红豆花开
爱情嫌疑犯	心咒
情迷惊梦	心咒
盛夏晚晴天电影版	爱在晚晴天
极速雄师2005	不停站的列车
龙虎豹	枭龙
在那遥远的小山村	阳光留守
小神来了：流星的魔法夜	小神来了
“封”门村	封门村
追回我的新娘	落跑新娘
瑞奇与叮当	银河守卫队
拉捷特与克拉克(台)	银河守卫队
玩命快递：肆意横行(台)	玩命速递：重启之战
玩命快递4	玩命速递：重启之战
非常人贩4	玩命速递：重启之战
玩命速递4	玩命速递：重启之战
梦魇惊情	诡魇
不法之徒	烈日灼心
法外之徒	烈日灼心
太阳黑子	烈日灼心
光斑	烈日灼心
小时代2	小时代2：青木时代
魁拔3	魁拔Ⅲ战神崛起
魁拔3战神崛起	魁拔Ⅲ战神崛起
魁拔3之战神崛起	魁拔Ⅲ战神崛起
福建女孩	高三女生部落格
狄道传奇	小西天狄道传奇
西部传奇	小西天狄道传奇
对你说	青春派
不需要初恋的夏天	青春派
最美乡村医生	最美的乡村医生
遥远的武功山	遥远的天熊山
遥远的大熊山	遥远的天熊山
香港仔	人间·小团圆
人间小团圆	人间·小团圆
曼珠沙华	人间·小团圆
北京爱情故事电影版	北京爱情故事
北爱电影版	北京爱情故事
夺命之旅	夺命旅行
豹女之夺命之旅	夺命旅行
夺面旅行	夺命旅行
家住泰山	山子的一家
剩女大逃亡	冷恋时代
北京，纽约	北京纽约
北京·纽约	北京纽约
催眠档案之彻夜未眠	催眠大师
一夜种马	有种你爱我
蝶变	蝴蝶海
夜孔雀·如果没有遇见你	夜孔雀
太空熊猫	太空熊猫历险记
飞鱼服绣春刀	绣春刀
斩立决	绣春刀
小丁奇遇记	丁丁奇遇记
女儿当自强	杨门女将之女儿当自强
微电影断弦	断弦
校园电影断弦	断弦
华科断弦	断弦
华科首部电影断弦	断弦
人人知道我爱你	像风一样行走
微时代的爱情	微爱之渐入佳境
微信时代的文艺爱情	微爱之渐入佳境
旧社会	罗曼蒂克消亡史
浮生如梦	罗曼蒂克消亡史
喜羊羊与灰太狼6	喜羊羊与灰太狼之飞马奇遇记
喜羊羊与灰太狼大电影6飞马奇遇记	喜羊羊与灰太狼之飞马奇遇记
迷魂	迷魂之密室逃脱
大学那点事儿之屌丝的逆袭	屌丝的逆袭
假冒者们	伪装者
冒充者们	伪装者
变异危机小于PM2.5	变异危机＜PM2.5
特种兵之战狼	战狼
兵锋	战狼
熊出没大电影	熊出没之夺宝熊兵
熊出没电影版	熊出没之夺宝熊兵
后宫诡影	深宫怨灵
后宫魅影	深宫怨灵
鬼迷宫	深宫怨灵
活尸	深宫怨灵
辛亥元勋	辛亥元勋蒋翊武
我是狼	我是狼之火龙山大冒险
江湖论贱实录	江湖论剑实录
江湖论贱	江湖论剑实录
即刻发生的搞笑绑架案	即刻发生
复仇者联盟3：无限之战(港)	复仇者联盟3：无限战争
复仇者联盟：无限之战(台)	复仇者联盟3：无限战争
复仇者联盟3：无尽之战	复仇者联盟3：无限战争
复联3	复仇者联盟3：无限战争
妇联3(豆友译名)	复仇者联盟3：无限战争
复仇者联盟3：灭霸传(豆友译名)	复仇者联盟3：无限战争
重振精武門	重振精武门
新精武门2	重振精武门
盗墓笔记电影版	盗墓笔记
陆川版鬼吹灯	九层妖塔
鬼吹灯之九层妖塔	九层妖塔
吹灯传说之精绝古城	九层妖塔
鬼吹灯	九层妖塔
马恒昌的名言	开国劳模马恒昌
开国劳模	开国劳模马恒昌
同桌的你	同桌的妳
唐家岭	今天明天
夺命训练班	海角惊魂
走进西藏	世界屋脊的歌声
小时代3	小时代3：刺金时代
小时代4	小时代4：灵魂尽头
不摇你就滚	那些五脊六兽的日子
爱情公寓电影版	爱情公寓
穿越时空的守护者	爱情公寓
终于，又双叒叕回来搞事情了	爱情公寓
新次元冒险家	爱情公寓
盗墓笔记同人版	爱情公寓
爱情公墓(豆友译名)	爱情公寓
81号农场	81号农场之保卫麦咭
这个杀手也不冷	冰封
闹在囧途	闹在碗中
愛·尋·迷	爱寻迷
高铁英雄电影版	高铁英雄
劇場版 トレインヒーロー	高铁英雄
客家妈妈	衍香
笔仙III	笔仙3
毒爱	毒·爱
我的老公是卧底	毒·爱
欢乐时光	快乐时光
拆弹军人	拆弹英雄
赵小亭	青春的应答
生命的应答	青春的应答
山路十八弯	南国
流氓之小流氓	流氓
南漂	她们，他们
天使love	天使LOVE之歧途
夜夜夜	疯狂72小时
很爱很爱你	狠狠爱
12公民	十二公民
十二个中国人	十二公民
我的春梦	我的青春期
我的青春	我的青春期
我的青春梦	我的青春期
飞越自由	移动的艺术
冬天不冷	疯狂的导演
细娃儿的呼唤	细娃的呼唤
我的第四个老公	好命先生
国家利益	难忘金银滩
大峡谷	赤道
赤盗	赤道
迷失的今天	今天
冰封侠：时空大战(港)	冰封侠：时空行者
时空行者	冰封侠：时空行者
冰封：永恒之门	冰封侠：时空行者
冰封2：永恒之门	冰封侠：时空行者
冰封2：回到未来	冰封侠：时空行者
3D冰封侠2	冰封侠：时空行者
黄飞鸿	黄飞鸿之英雄有梦
人品鉴定	衡量一个人
夫妻对换	换爱之夜
儿子娃娃向前冲	我和我的小伙伴
夜店北京2：女神本色	夜店北京2：女神禁区
傻X时代	傻瓜时代
地下电影：保安，保安的朋友，保安的朋友的女朋友	傻瓜时代
协议	风尘劫
金雞SSS	金鸡SSS
金鸡3	金鸡SSS
幸福的泪	我的母亲
妈妈的爱	我的母亲
红雀特工(港)	红雀
红色麻雀	红雀
红燕子	红雀
红麻雀	红雀
朱雀	红雀
201413·爱你一世一生	爱你一世一生
山路十八弯	青葱那年
南国	青葱那年
痞子英雄2：黎明再起	痞子英雄2：黎明升起
痞子英雄2	痞子英雄2：黎明升起
痞子英雄电影版2	痞子英雄2：黎明升起
痞子英雄之黎明升起	痞子英雄2：黎明升起
夏日后的远行	夏日的远行
人再囧途之港囧	港囧
人在囧途之港囧	港囧
泰囧续集	港囧
花开	花开与你的半夏
真爱无悔	下一站再爱你
天使有约	下一站再爱你
毕业48小时	我们毕业的夏天
我的十字路口	父子战争
盜馬記	盗马记
贩马记	盗马记
一步双城	一生一世
心城	一生一世
异度曝光	诡替身
狗13	狗十三
爱因斯坦和爱因斯坦	狗十三
8点45分	八点四十五分
玩命邂逅	心花路放
玩儿命邂逅	心花路放
心花怒放	心花路放
病例	保持安静
羞耻病	保持安静
远东一九三二（上）阴阳大逆转	远东一九三二（上）阴阳大策反
英雄·本色	英雄之战
龙震天下	英伦对决
普通人	英伦对决
中国人	英伦对决
外国佬	英伦对决
菇乡情缘	第一次牵手
聊斋之宅妖	捉妖记
聊斋之捉妖记	捉妖记
點對點	点对点
永春白鹤拳	永春白鹤拳之擎天画卷
去死！	嘿
寻找麦卡尼	寻找罗麦
N见钟情	37次想你
幸福中转站	幸福中转栈
聊斋·非狐外传	非狐外传
全家福	父亲的旅程
天台	天台上的爱情
我想结婚	我想结婚的时候你在哪
动机	折影
二胡大师黄海怀	黄海怀
伊甸园之东下	伊甸园之东2
温州保姆	一个温州的女人
出镜入境	一个温州的女人
悠长世纪恋爱假期	恋爱假期
梦游症和神经病	恋爱假期
7日	七日
深夜前的5分钟	深夜前的五分钟
凌晨前的五分钟	深夜前的五分钟
真夜中の5分前	深夜前的五分钟
打望	爱情幸运星之打望
F-TYPE 非你莫属	非你莫属
谁是卧底之王牌	王牌
寒蟬效應	不能说的夏天
寒蝉	不能说的夏天
桃花红 杏花白	没眼人
早安·冬日海	早安，冬日海
左耳电影版	左耳
恐怖在線	午夜43路
幸福快遞	幸福快递
包打探：铁血兵团	暴走神探
包打探手记	暴走神探
转身遇到她	0.5的爱情
上海之恋	我们结婚吧
摇滚狗波迪	摇滚藏獒
我们，结婚吧	我们结婚吧
喋血神兵	黔东烽火
十五少年漂流記 海賊島DE！大冒険(日)	喵星少年漂流记
十五少年漂流记 海贼岛大冒险	喵星少年漂流记
外冲里不冲	青瓷迷踪
老男孩之猛龙过江	老男孩猛龙过江
老男孩电影版	老男孩猛龙过江
特工艾米拉之生化危机	特工艾米拉
戴笠之死	岱山秘案
逃避侮辱的人	被淘汰的人
花瑶	花瑶情
闺蜜之青春盛宴	青春盛宴
外围	青春盛宴
暗夜迷眸	闪魂
木兰传奇	花木兰传奇
城市爱情1997	冬日爱情
人心可畏	猜心之人心可畏
爱，西施豆腐	爱·西施豆腐
踏雪寻梅之蝶记江湖	踏雪寻梅
滿月酒	满月酒
藥命實驗	后知后觉
荣誉的证明	舍身技
好人常慧珍	常慧珍
梅花胸针	爱情碰碰撞
强渡乌江	强渡乌江之对岸
突破乌江	强渡乌江之对岸
女人与老头	迟与暮
如此美好	迟与暮
侠僧探案传奇3	侠僧探案传奇之白马镖局
少林寺探案传奇之白马镖局	侠僧探案传奇之白马镖局
消失的子弹2	消失的凶手
败女大翻身	美人邦
古剑奇谭2：偃师传奇	古剑奇谭2：永夜初晗
青春的季节之爱情的果实	青春的季节
风雨杨开慧	毛泽东与杨开慧
梦想预备生之半熟少女	半熟少女
半熟少女之梦想预备生	半熟少女
爱情达人	有招没招之爱情达人
送你一束玫瑰花	了不起的村庄
血色挂云山	挂云山
楚汉风云	大汉风之霸王别姬
霸王别姬	大汉风之霸王别姬
《智盗海鳅图》	顾大嫂与孙新
爸爸去哪儿电影版	爸爸去哪儿
爸爸去哪儿大电影	爸爸去哪儿
整容医院背后的故事	完美
寻龙	龙在哪里？
龙在哪儿	龙在哪里？
记忆森林：张家界之恋	记忆森林
愛琳娜	爱琳娜
马！笔！剑！人	世事难料2
世事难料 第二季	世事难料2
巴啦啦小魔仙2	巴啦啦小魔仙之魔法的考验
Z風暴	反贪风暴
Z风云	反贪风暴
反贪风暴2014	反贪风暴
笑弹龙虎榜	新白头神探
七宝传奇之汆来神钟	神钟
七宝传神之氽来神钟	神钟
澳門街	澳门街
沙人	睡魔
睡魔：序曲	睡魔
约翰·威克	疾速追杀
杀神(港)	疾速追杀
捍卫任务(台)	疾速追杀
亲爱的小孩	亲爱的
打拐	亲爱的
家之亲爱的小孩	亲爱的
小镇之光	南方小镇
最强对手	解救吾先生
怪蛋传奇	怪蛋之谜
少林武士	少林武僧
西游2：伏妖篇	西游伏妖篇
西游降魔篇2	西游伏妖篇
西游·降魔篇2	西游伏妖篇
西游·降魔2	西游伏妖篇
枪	鹦哥岭，最后一
情趣产品体验员	拼时代
潜艇总动员4：章鱼保罗	潜艇总动员4：章鱼奇遇记
斐济99度爱情	斐济99℃爱情
斐济99℃的爱情	斐济99℃爱情
聪明的一休	聪明的一休之反斗公主
一休小和尚	聪明的一休之反斗公主
一休さん	聪明的一休之反斗公主
十万个冷笑话电影版	十万个冷笑话
我愛草食男2	我爱草食男2
毕业那年2	毕业那年：分手季
十万伙急	热血男人帮
热血天团	热血男人帮
PK白富美	情战
我们的存在-梦想启航	我们的存在WE
极限追捕(港)	极盗者
飙风特攻(台)	极盗者
惊爆点	极盗者
新终极豪情	极盗者
大茶飯	潜龙风云
衝鋒車	冲锋车
日月人鱼：国王的女儿	日月人鱼
路易十四与美人鱼	日月人鱼
顺溪的孩子	那年，温州
湄公河大案	湄公河行动
湄公河	湄公河行动
她的亡命之徒	一战到底
红夜2014	红夜
坚果行动2(台)	抢劫坚果店2
古惑松鼠之饥饿任务2(港)	抢劫坚果店2
坚果计划2	抢劫坚果店2
回家	反杀
横财局中局（港）	钞票飞
唐家山之恋	兰辉
魔幻仙踪之妈妈去哪儿	魔幻仙踪
致命绑架	领养惊魂
归还	领养惊魂
血泪代言	潜规则2：血泪代言
时光飞逝	时光列车
天将雄狮	天将雄师
天降雄狮	天将雄师
此去经年 之 共同度过	此去经年之共同度过
男人唔可以窮	男人不可以穷
分手100次	不再说分手
全力扣殺	全力扣杀
羽魔球	全力扣杀
野狼與瑪莉	野狼与玛莉
野狼与玛丽	野狼与玛莉
宅男女神杀人狂	野狼与玛莉
西游记之大闹天宫续集	西游记之孙悟空三打白骨精
西游记之三打白骨精	西游记之孙悟空三打白骨精
三打白骨精	西游记之孙悟空三打白骨精
西游记·女儿国	西游记女儿国
西游记之女儿国	西游记女儿国
五女拜寿(花鼓戏)	五女拜寿
千億惡魔愛上我	千亿恶魔爱上我
港版风月俏佳人	千亿恶魔爱上我
風中家族	对风说爱你
红颜露水	露水红颜
失戀急讓	临时同居
军刺	军刺之不良少年
鞭炮	鞭·炮I
风雪天山路	生死天山路
那年承诺	那年我对你的承诺
儿女传奇之绅士大盗	绅士大盗
迷城	谜城
暴走迷城	谜城
Q版三国之三小强 大电影	三小强
怪談電影-屍骸之路	怪谈电影：尸骸之路
怪谈电影第一部	怪谈电影：尸骸之路
地上地下	欲望北京之地上地下
世界大对战(台)	像素大战
屈机起格命(港)	像素大战
像素入侵	像素大战
天煞：像素之战	像素大战
像素之战	像素大战
拜金女	空姐
情毒	抗暴生死情
囧游	凤凰谷
囧游凤凰谷	凤凰谷
叵测情书	那年的情书
雅望天堂	夏有乔木
夏有乔木，雅望天堂	夏有乔木
夏有乔木	夏有乔木
雅望天堂	夏有乔木
藏羚王	藏羚王之雪域精灵
太空熊猫2	太空熊猫总动员
赛尔号4	赛尔号大电影4：圣魔之战
摩尔庄园大电影3魔幻列车大冒险	摩尔庄园3：魔幻列车大冒险
特功明星李多多	特功明星
特功明星大电影	特功明星
布基兰小站	布基兰
陆垚知马莉	陆垚知马俐
超人特攻队2(台)	超人总动员2
超人特工队2(港)	超人总动员2
超人家族2	超人总动员2
结婚大作战中国版	新娘大作战
夢海	梦海
梦海追击	梦海
边缘线	全城通缉
张先生与张先生	张先生和张先生
张先生	张先生和张先生
封神榜	封神传奇
3D封神榜	封神传奇
封神传奇之雷震子	封神传奇
失踪的戒指	戒心
毛克利	森林之子毛克利
毛克利：魔森丛现(港)	森林之子毛克利
丛林之书：起源	森林之子毛克利
森林王子	森林之子毛克利
莫格利	森林之子毛克利
Where It Born，冬日已东	陈仓已冬
链爱	链·爱
魔都十二星座	魔都爱之十二星座
哪一天我們會飛	哪一天我们会飞
差一点我们会飞	哪一天我们会飞
爱的根源	哪一天我们会飞
密道追踪	密道追踪之阴兵虎符
蜜月酒店	蜜月酒店杀人事件
最青春	我未成年
整形师	整形师·脸
记忆贩卖器	黑暗之光
破風	破风
私家偵探	私家侦探
鬥獸棋	斗兽棋
八角街的出租车	德吉的诉讼
梅林：失踪岁月	少年梅林
闺蜜2：无二不作	闺蜜2
闺蜜2：单挑越南黑帮	闺蜜2
诡捌楼	诡八楼
枉死楼之诡八楼	诡八楼
壹獄壹世界：高登闊少踎監日記	一狱一世界：高登阔少蹲监日记
喜禾·珍爱	喜禾
俠盜聯盟	侠盗联盟
大宅們	大宅男
开心超人2	开心超人2：启源星之战
绿林大冒险之糖果世界	糖果世界大冒险
绿林大冒险2	糖果世界大冒险
再見，阮玲玉	再见，阮玲玉
賭城風雲II	澳门风云2
白色嫌疑人	判我有罪
判我死刑	判我有罪
中国小姐	中国女合伙人之创业邦
红色马甲	禁止吸烟
无痛	嫂子去哪儿
小神笛的秘密	情笛之爱
蹴鞠	仙球大战
我的妈妈是富婆	为了孩子的明天
萧何月下追韩信	萧何月下追韩信(京剧)
抱养	抱养奇缘
水浒人物谱之没羽箭张清	没羽箭张清
72小时：双十一来了	72小时：购物狂欢的背后
营救飞虎队	烽火芳菲
中国寡妇	烽火芳菲
我的美女总裁老婆	泡上美女总裁
索命暹罗	索命暹罗之按摩师
按摩师	索命暹罗之按摩师
怪兽通缉令	老大别怕
第七謊言	第七谎言
重返二十岁	重返20岁
奇怪的她中国版	重返20岁
五個小孩的校長	可爱的你
五个小孩的校长	可爱的你
5个小孩的校长	可爱的你
圣地渴望	渴望的青春
忠诚者(下)	分歧者3：上升之势
效忠者(下)	分歧者3：上升之势
分歧者3：效忠者(下)	分歧者3：上升之势
分歧者3：忠诚者(下)	分歧者3：上升之势
我的23岁	我的23岁之无码青春
县委书记焦裕禄	县委书记
焦裕禄	县委书记
我的舞台	致我们曾经追逐的梦想
别让我知道你的秘密	我只要我们在一起
路小路，你有种！	少年巴比伦
遇见彩虹	幸福梦想
山娃子的春晚梦	鼓点上的梦
鼓魂	鼓点上的梦
寻母	妈妈去哪儿
年年有爱	一路惊喜
Peacocking（英）	匹客王
转移	奇葩追梦
画个圈圈诅咒你	画个圈圈
真爱无声	真爱
情暖天山	真爱
铁木真传说	战神纪
铁木真传奇	战神纪
铁木真大帝之传说	战神纪
苍狼白鹿	战神纪
战龙觉醒(港)	超凡战队
金刚战士(台)	超凡战队
恐龙战队	超凡战队
恐龙战队 真人版	超凡战队
超级战队	超凡战队
超能战队	超凡战队
纽约童话	纽约纽约
前任2备胎反击战	前任2：备胎反击战
现任攻略	前任2：备胎反击战
男人攻略	前任2：备胎反击战
备胎攻略	前任2：备胎反击战
前任攻略2	前任2：备胎反击战
狄仁杰3	狄仁杰之四大天王
麥兜‧我和我媽媽	麦兜我和我妈妈
麦兜·我和我妈妈	麦兜我和我妈妈
麦兜故事6	麦兜我和我妈妈
毕业说爱你	缘来柿你之告白
记忆战	记忆大师
催眠大师2	记忆大师
猪猪侠大电影2	猪猪侠之勇闯巨人岛
猪猪侠2	猪猪侠之勇闯巨人岛
六次别离	爸爸的3次婚礼
我和初恋的三次婚礼	爸爸的3次婚礼
爸爸的三次婚礼	爸爸的3次婚礼
姐妹2之再见青春	姐妹2再见青春
让红包飞	恋爱大师之让红包飞
猎猎西风劲	生死底线
泰国妖医	妖医
泰恋	妖医
屍城	尸城
活尸竞技场	尸城
天師鬥殭屍	天师斗僵尸
僵尸TV	天师斗僵尸
燃烧的罪恶	燃烧罪恶
麦兜·麦露宝	麦兜·饭宝奇兵
乌拉诺斯	告别
山河恋人	山河故人
金童子	古曼
古曼怨灵	古曼
求婚清单	清单
吕剧断桥惊魂	断桥惊魂
裸归2014	裸归电影版
屌丝男士大电影	煎饼侠
洛克王国3之圣龙的守护	洛克王国3：圣龙的守护
搏击奇缘(港)	搏击迷城
五行攻略	搏击迷城
恋曲·无爱不欢	恋曲之无爱不欢
巴士进行曲 On the bus	巴士进行曲
无情人贩子	勇者无畏
曖昧不明關係研究學會	暧昧不明关系研究学会
杜鹃花之恋	爱你的人
老海的幸福生活	老海的新生活
中国·制造	打工老板
水煮金蟾	温水蛤蟆
水浒前传之孙二娘	拼命三娘
水浒前传之拼命三娘	拼命三娘
韩索罗：星球大战外传(港)	游侠索罗：星球大战外传
星球大战外传：游侠索罗	游侠索罗：星球大战外传
星球大战外传：索罗	游侠索罗：星球大战外传
星球大战韩·索罗外传	游侠索罗：星球大战外传
游侠索罗	游侠索罗：星球大战外传
韩索罗外传	游侠索罗：星球大战外传
星战外传2	游侠索罗：星球大战外传
纽约人在北京	我是马布里
巴希库大冒险	龙骑侠
果果骑侠传电影版	龙骑侠
伙伴青春不散	伙伴·青春不散
撞青春之梦开始的地方	撞青春
六世古宅	通灵之六世古宅
替身	通灵之六世古宅
死亡替身	通灵之六世古宅
3D通灵	通灵之六世古宅
相约小舟山之油菜花香	缘来小舟山
拆婚联盟	坏姐姐之拆婚联盟
爱情麻辣烫2015	爱情麻辣烫之情定终身
魔镜3D	魔镜
古镜怪谈	魔镜
怪谈之魔镜	魔镜
横冲直撞荷里活(港)	横冲直撞好莱坞
横冲直闯好莱坞	横冲直撞好莱坞
夜半梳头2	梳头2
血寡妇3	梳头2
宅男剩女	苟不理与戴安娜
整容归来	整形归来
榆林杂种	榆林杂碎
思绪波动	角色问题
第3种爱情	第三种爱情
梦幻假期	梦幻佳期
旧金山寻梦之梦幻佳期	梦幻佳期
酒国英雄之摆渡人	摆渡人
摆渡之人	摆渡人
致永不消逝的青春	我的青春永不逝
铁血战士新续集	铁血战士
终极战士：掠夺者(台)	铁血战士
铁血战士：血兽进化(港)	铁血战士
铁血战士4	铁血战士
殡棺	心迷宫
春風	春风
走吧！	盛宴
时间都去哪儿了	时间都去哪了
喊个没完	命运速递
兔侠传奇2：青黎传说	兔侠之青黎传说
师傅	师父
尸体	尸台社区
老虎与小猫	鲁彪与小猫
青田街一號	青田街一号
最后夏天	最后的夏天
做地產	做地产
獅子山下2014：做地产	做地产
一仆三主	一团乱麻
罗生特医生	罗生特大夫
长安乱	喜乐长安
简单。爱	简单爱
奔跑的月光	一个勺子
販賣．愛	贩卖·爱
我的援交日记	贩卖·爱
苏州情书2—时间里	时间里
东方动画：秘封神隐之旅	秘封神隐之旅
邓小平在黄山	邓小平登黄山
喜从天降，空姐不慌张	浪漫天降
浪漫从天降	浪漫天降
怵欲	朝外81号
御狐之绊：女神归位	御狐之绊
太陽留住我	太阳留住我
极速世界·战车	极速世界之战车
媽咪俠	妈咪侠
小姐誘心	爱情攻略
性爱伙伴秘密	爱情攻略
拍立得	宝丽莱
宝丽来	宝丽莱
史来贺	大地赤子史来贺
没門(港)	没门
疯狂的戒指	一克拉的承诺
承诺	一克拉的承诺
戒指	一克拉的承诺
特工斯托姆：我在基地的日子	特工斯托姆
黑幕	青春.com
關你喵事	关你喵事
我的家就在藍色多瑙河	关你喵事
松節油之味	松节油之味
小巷女总统	小区来了新主任
鬼局之僵尸都去哪儿了	鬼局
特工爺爺	我的特工爷爷
老卫兵	我的特工爷爷
步步惊心	新步步惊心
步步惊心电影版	新步步惊心
生命处方	天使：生命处方
生命密码	天使：生命处方
校花驾到	校花驾到之极品校花
死開啲啦	死开啲啦
家有僵尸少爷	死开啲啦
王家欣	寻找心中的你
爸爸去哪儿2电影版	爸爸去哪儿2
爸爸去哪儿2大电影	爸爸去哪儿2
给未知恋人的情书	青春序
心得乐大电影	宝贝，对不起
孩子去哪儿：心得乐	宝贝，对不起
忍者龟：魅影突击(港)	忍者神龟2：破影而出
忍者龟：破影而出(台)	忍者神龟2：破影而出
忍者神龟2	忍者神龟2：破影而出
真人版忍者神龟2	忍者神龟2：破影而出
我的中国娃娃	迦太基茉莉
太平轮(下)：彼岸	太平轮(下)·彼岸
太平轮II：惊涛挚爱(台)	太平轮(下)·彼岸
生死恋	太平轮(下)·彼岸
跳水梦	激情跳水梦
3D食人虫	食人虫
学号44	晚安吓
晚安夏（续）	晚安吓
远东特遣队 第2部 狭路相逢	远东特遣队之狭路相逢
远东特遣队 第3部 重点爆破	远东特遣队之重点爆破
额吉的飞机场	母亲的飞机场
星人系列之FLY星人失能事件	FLY星人失能事件
青春鬥	精武青春
天使高校	精武青春
至少还有你	既然青春留不住
勇敢的菠菜	既然青春留不住
当菠菜遇上空心菜	既然青春留不住
敢死队伍	狙击时刻
远东特遣队 第四部 鬼城计划	远东特遣队之鬼城计划
远东特遣队 第五部 飞龙行动	远东特遣队之飞龙行动
远东特遣队 第六部 密令截击	远东特遣队之密令截击
远东特遣队 第七部 狼穴探秘	远东特遣队之狼穴探秘
远东特遣队 第八部 铁血奇兵	远东特遣队之铁血奇兵
远东特遣队 第九部 夺桥喋血	远东特遣队之夺桥喋血
新大头儿子和小头爸爸大电影	新大头儿子和小头爸爸之秘密计划
踏血尋梅	踏血寻梅
黑白灰三部曲第一部	灰
远东特遣队 第十部 最后一战	远东特遣队之最后一战
秘术之盗墓江湖	秘术
盗墓空间	秘术
欢喜冤家	失恋联盟
心愿情缘	美好的心愿
白领爱情	一起脱单吧
男友的女友	艳遇2小鲜肉
十月初五的月光电影版	十月初五的月光
澳门街	十月初五的月光
倒转100	每日100词
年青时代1女人心	年轻时代之女人心
年青时代：女人心	年轻时代之女人心
奢华时代之女人心	年轻时代之女人心
追梦	村长相声哥
找个高富帅	找个高富帅？
谈婚论嫁18天	找个高富帅？
白鹭与龟	白鹭和龟
死亡之谜之双鱼玉佩	死亡之谜
亲密陷阱	亲密的陷阱
我的热辣女上司	艾米与超帅
一瞬间爱上你	什么是10秒钟爱情
The waves（英）	浪
奇緣灰姑娘	奇缘灰姑娘
陌路恋情	陌路情恋
七侠葫芦传	葫芦七侠
移动迷宫3	移动迷宫3：死亡解药
死亡解药	移动迷宫3：死亡解药
冥婚啟示(港)	非常婚事
小灵媒	非常婚事
女刑警之指纹专家	神秘指纹
女刑警之神秘指纹	神秘指纹
分手不分手	分手，不分手
光明	全能囧爸
都说我怂我忍了	临时业主
新野蛮女友	我的新野蛮女友
栀子花开2015	栀子花开
孤岛惊魂	孤岛
饕餮刑警	西北风云
捉“鬼”记	东北偏北
莲花行动	谍·莲花
上门女郎	嗨，上门女郎
小米的七色花	七色花
炙爱青春	重生爱人
重生恋人	重生爱人
上位2之盛筵	上位2
喊山	喊·山
天使维拉	飞来的青衣
危城歼霸	危城
夕阳武士	危城
咱们结婚吧电影版	咱们结婚吧
神奇动物在哪里2：格林德沃之罪	神奇动物：格林德沃之罪
怪兽与葛林戴华德之罪(港)	神奇动物：格林德沃之罪
怪兽与葛林戴华德的罪行(台)	神奇动物：格林德沃之罪
神奇动物在哪里2	神奇动物：格林德沃之罪
神奇动物2	神奇动物：格林德沃之罪
莫道君行早	凤凰台
小蜡笔们的彩色世界大冒险	蜡笔总动员
与敌人的蜜月	情敌蜜月
紅色的迴廊	红色的回廊
系在皮绳扣上的魂	皮绳上的魂
水浒人物谱之青眼虎李云	青眼虎李云
奇人密碼：古羅布之謎	奇人密码：古罗布之迷
地道	隧道
惡人谷	恶人报喜
恶人不坏	恶人报喜
捍卫生死线(台)	克隆人
复制品	克隆人
复生人	克隆人
复制人	克隆人
火烧云	快手枪手快枪手
快手·枪手·快枪手	快手枪手快枪手
龙城计中计	快手枪手快枪手
分手木马	分手木马计
惊心破	惊天破
破地狱	惊天破
魂断霞飞路	魔宫魅影
魔都18号	魔宫魅影
魔都魅影	魔宫魅影
魔都14号	魔宫魅影
熊出没大电影2	熊出没之雪岭熊风
潜艇总动员5	潜艇总动员5：时光宝盒
潜艇总动员之时光宝盒	潜艇总动员5：时光宝盒
喜羊羊与灰太狼7	喜羊羊与灰太狼之羊年喜羊羊
喜羊羊与灰太狼大电影7羊年喜羊羊	喜羊羊与灰太狼之羊年喜羊羊
跳街舞的少年	街舞小子
落跑吧愛情	落跑吧爱情
我的澎湖湾	落跑吧爱情
落跑吧，爱情	落跑吧爱情
東京・北京 学生たちの対話 どうなる！日本と中国	早稻田大学和北京大学学生之间的对话
早稻田大学和北大学生之间的对话	早稻田大学和北京大学学生之间的对话
梅花	爱你不等来生
缘来说再见(港)	已是香港明日
梦想的逆时代	最后的学生时代
烟火黎明	平安之盾
七天	冬
万万没想到之千钧一发	万万没想到：千钧一发
那年離家出走去	那年离家出走去
幸福家庭打造计	非常父子档
不期儿遇	非常父子档
神奇马戏团	神奇马戏团之动物饼干
动物饼干	神奇马戏团之动物饼干
爱后爱	思念爱
青蛙王国2	青蛙王国之冰冻大冒险
延安审判	人间正道
巴顿、查理、凯科和比尔	巴顿与查理
土家金凤冠	我不是贼
何以笙箫默电影版	何以笙箫默
新狼人	狼人
商谍之决战襄王府	商谍2
浮華宴	神探驾到
神探到访	神探驾到
玻璃侦探	神探驾到
草原情	遥远的锡林郭勒
有本事你来· 夫妻篇	有本事你来之夫妻篇
约书亚树	美国家庭
見えない貌	看不见的脸
小爱无疆	轮椅上的梦之小爱无疆
雷锋侠	热血雷锋侠之激情营救
粵語殘片	粤语残片
无声的群落——老知青的故事	老知青的故事
绣春刀2：修罗战场	绣春刀II：修罗战场
绣春刀：修罗场	绣春刀II：修罗战场
绣春刀前传	绣春刀II：修罗战场
西西里艳阳下	谎言西西里
我前男友的葬礼	谎言西西里
西西里的艳阳下	谎言西西里
同流合烏	同流合乌
12金鴨	12金鸭
十二金鸭	12金鸭
金鸭	12金鸭
深圳萌萌哒	等你回家
金朝奉	生死船票
奔跑吧兄弟	奔跑吧！兄弟
奔跑吧兄弟电影版	奔跑吧！兄弟
跑男电影版	奔跑吧！兄弟
角頭	角头
天生我刺	刺猬小子之天生我刺
非法操作	不可思异
爱在扬州	神州之恋
大圣归来	西游记之大圣归来
猴王	西游记之大圣归来
西游记3D	西游记之大圣归来
包公：黑夜之神	黑夜之神
拍到鬼的录像	灵异实录
从天儿降	从天“儿”降
鴨王	鸭王
赤裸的朱丽叶	赤裸朱丽叶
一碗馄饨2	温暖的阳光
吃吃的爱	“吃吃”的爱
吃吃睡睡爱	“吃吃”的爱
绝命航班2：蒸发太平洋	蒸发太平洋
向阳花·开	向阳花开
是个圈儿	朋友是个圈
土豪的情人节	土豪520
大囍臨門	大喜临门
三言二拍之一枝梅	一枝梅
冇鬼故事	没鬼故事
瑪連箂的凝視	玛莲箂的凝视
再見，在也不見	再见，在也不见
距离	再见，在也不见
潜入者	突维
与青春一战	青春一战
哥门儿情谊	哥们儿情谊
大话西游终结篇	大话西游3
游戏在线	时光大战
十年	匆匆那些年
遇见另一个自己(台)	虚构的我
机器人班长	魔幻魅力
枕边人	枕边诡影
枕边鬼影	枕边诡影
暗黑之心(港
黑暗心灵
台)	黑暗心灵
乌龙囧探	暴走囧探
青春之殇2	青春之殇II：归期无期
坏蛋别惹我	坏蛋必须死
李雷和韩梅梅之昨日重现	李雷和韩梅梅
消失吧！肿瘤君	滚蛋吧！肿瘤君
消失吧，肿瘤君	滚蛋吧！肿瘤君
翻滚吧！肿瘤君	滚蛋吧！肿瘤君
水浒人物谱之丑郡马宣赞	丑郡马宣赞
逗比时代之混婚	逗比时代·混婚
三言二拍	孤女奇冤
美食大冒险	美食大冒险之英雄烩
台东女中之传奇鼎东客运女孩	神秘家族
儿女传奇之厨神	厨神
普2青年电影版	普2青年
三條友飲醉走	3条友饮醉走
岁城璃心之鬼蜮咒原篇	岁城璃心-鬼蜮咒原
商学院合伙人	梦想合伙人
青春合伙人	梦想合伙人
青春盛筵2	青春盛宴2：边沿
半根烟	青春盛宴2：边沿
微微一笑很倾城电影版	微微一笑很倾城
我本纯良	男神时代
脱轨时代2	男神时代
脱轨时代II：男神时代	男神时代
侠僧探案传奇1	侠僧探案传奇之聚义钱庄
少林寺探案传奇之聚义钱庄	侠僧探案传奇之聚义钱庄
侠僧探案传奇2	侠僧探案传奇之王陵之谜
少林寺探案传奇之王陵之谜	侠僧探案传奇之王陵之谜
功夫新娘	功夫新娘之白金恋人
感恩23	感恩23°
侠僧探案传奇4	侠僧探案传奇之大兴赌坊
少林寺探案传奇之大兴赌坊	侠僧探案传奇之大兴赌坊
王子与一百零八煞	王子与108煞
水浒-108煞星(台)	王子与108煞
侠僧探案传奇5	侠僧探案传奇之洛阳花会
少林寺探案传奇之洛阳花会	侠僧探案传奇之洛阳花会
侠僧探案传奇6	侠僧探案传奇之醉玲珑
少林寺探案传奇之醉玲珑	侠僧探案传奇之醉玲珑
侠僧探案传奇7	侠僧探案传奇之开封府
少林寺探案传奇之开封府	侠僧探案传奇之开封府
侠僧探案传奇8	侠僧探案传奇之催命符
少林寺探案传奇之催命符	侠僧探案传奇之催命符
侠僧探案传奇10	侠僧探案传奇之大夜叉
少林寺探案传奇之大夜叉	侠僧探案传奇之大夜叉
侠僧探案传奇9	侠僧探案传奇之将军府
少林寺探案传奇之将军府	侠僧探案传奇之将军府
不能拆的礼密(港)	致命礼物
非礼勿弑(台)	致命礼物
礼物	致命礼物
爱是蓝色的	醉·生梦死
醉生梦死	醉·生梦死
一兵一卒	枪过境
中华小子	功夫小龙
青親	青亲
第一届中韩歌会	中韩歌会
韩中歌谣祭	中韩歌会
韩中歌谣祭	第三届中韩歌会
漫步在薄暮里	园是故人来
消失的爱人(港)	消失爱人
看不见的秘密	消失爱人
新乌龙院	新乌龙院之笑闹江湖
韩中歌谣祭	第五届中韩歌会
韩中歌谣祭	第七届中韩歌会
韩中歌谣祭	第九届中韩歌会
星语心愿之再·爱	星语心愿之再爱
手机饭	手机·饭
韩中歌谣祭	第十一届中韩歌会
韩中歌谣祭	第十三届中韩歌会
韩中歌谣祭	第十五届中韩歌会
唐人街·探案	唐人街探案
唐探	唐人街探案
笑傲江湖电影版	笑傲江湖
书宇你好吗	第二次爱你
十萬夥急	十万伙急
盲证	我是证人
盲	我是证人
我的老爸喵星人(台)	九条命
亿万喵星人(港)	九条命
1屋2欺	一屋二欺
新永不消逝的电波	密战
我们的十二年一个轮回这是传奇	有我在这里
我在这里	有我在这里
我在这呢	有我在这里
我在这儿	有我在这里
奥拉星大电影	奥拉星：进击圣殿
奥拉星：至暗的启示	奥拉星：进击圣殿
秦时明月之帝子降兮	秦时明月特别篇之帝子降兮
万万没想到：西游篇	万万没想到
万万没想到电影版	万万没想到
青春闪闪·逐梦表演系	纯洁心灵·逐梦演艺圈
北京遇上西雅图2	北京遇上西雅图之不二情书
杜拉拉升职记2	杜拉拉追婚记
杜拉拉2之杜拉拉追婚记	杜拉拉追婚记
追婚日记(港)	杜拉拉追婚记
五十度灰3	五十度飞
格雷的五十道色戒3(港)	五十度飞
格雷的五十道阴影：自由(台)	五十度飞
五十度自由	五十度飞
阿里巴巴：大盗奇兵	阿里巴巴大盗奇兵
2015年春晚	2015年中央电视台春节联欢晚会
铁翼重生之密林喋血	铁翼重生之枪林弹雨
西安事变	凤凰大视野
盐城之恋2之鹤舞盐城	鹤舞盐城
谁动了我的未婚妻	海岛之恋
缉凶	围城缉凶
熊出没大电影3	熊出没之熊心归来
怪侠欧阳德电影版	大笑江湖2
疯了！桂宝	桂宝之爆笑闯宇宙
桂宝大电影之爆笑闯宇宙	桂宝之爆笑闯宇宙
桂宝	桂宝之爆笑闯宇宙
鲁豫和她的朋友·我的家庭日	鲁豫和她的朋友们
凤凰大视野 万世法门之谜	万世法门之谜
眼界：怒海追击	怒海追击
碟仙诡谭Ⅱ(3D)	碟仙诡谭2
5月一号	十七岁
五月一号	十七岁
17岁	十七岁
十七岁的你，好吗	十七岁
杀神John Wick 2(港)	疾速特攻
捍卫任务2：杀神回归(台)	疾速特攻
疾速追杀2	疾速特攻
极速追杀：第二章	疾速特攻
约翰·威克2	疾速特攻
賭城風雲III	澳门风云3
赌城风云III(港)	澳门风云3
鐵獅玉玲瓏2	铁狮玉玲珑2
山鬼	空山异客
都市特种兵	特种兵归来
毕业那一年	迷与狂
碟中谍6	碟中谍6：全面瓦解
不可能的任务：全面瓦解(台)	碟中谍6：全面瓦解
职业特工队：叛逆之谜(港)	碟中谍6：全面瓦解
使徒行者电影版	使徒行者
二见钟情	假如王子睡着了
乌龙未婚妻	假如王子睡着了
女总裁和她的男人们	羊入壶口
大话西游之妖怪别跑	西游之妖怪别跑
血鬥淑女	血染淑女
严厉的月亮	严肃的月亮
开工大“急”	开工大急
靈魂相認	灵魂相认
惶然录	路边野餐
最后三小时	死亡电话
解开最后一颗纽扣	一颗纽扣
非我莫属	不能错过
願望清單	愿望清单
鸭尊宝	超能太阳鸭
陀地驅魔人	陀地驱魔人
鬼泣	陀地驱魔人
《未（MADAYO）》	夜明前的微不足道~未
七月半	七月半之恐怖宿舍
七月半之幽灵女舍	七月半之恐怖宿舍
杏福来敲门	“杏”福来敲门
欢乐的色买提	“杏”福来敲门
少女小时代	半熟少女
扮熟少女	半熟少女
一线生机	异种
女汉子完美恋人	女汉子真爱公式
穿越版小龙人找妈妈	西游外传
我要拍电影	我的导演梦
状元媒	状元媒(京剧)
状元媒(戏曲电影)	状元媒(京剧)
同班同學	同班同学
同班同学2015	同班同学
罗宾汉：起源	罗宾汉
罗宾汉崛起(台)	罗宾汉
箭神·第一战(港)	罗宾汉
金箍棒传奇2	金箍棒传奇2：沙僧的逆袭
夺宝幸运星大电影之金箍棒传奇2	金箍棒传奇2：沙僧的逆袭
开心西游记2	金箍棒传奇2：沙僧的逆袭
回到唐朝当贵妃	回到唐朝做贵妃
抗日佐罗	暗剑
愛在深秋	爱在深秋
無仁義之戰	无仁义之战
幸運是我	幸运是我
龍鳳風雲	龙凤风云
藍天白雲	蓝天白云
小鬼当家	宝贝当家
海闊天空	飘洋三侠
漂洋三侠	飘洋三侠
逍遥时光	天亮之前
星语心愿之十一天零一夜	十一天零一夜
星语心愿2	十一天零一夜
星愿2	十一天零一夜
S風暴	反贪风暴2
Z风暴2	反贪风暴2
老笠便利店	老笠
我們停戰吧	我们停战吧
不能怨我	死爱
末代叛亂犯	末代叛乱犯
死局	逝言
制裁特攻	伸冤人2
私刑教育2(台)	伸冤人2
叛谍裁判2(港)	伸冤人2
洛克王国4之出发！巨人谷	洛克王国4：出发！巨人谷
洛克王国大电影4出发！巨人谷	洛克王国4：出发！巨人谷
血色牌坊	牌坊下的女人
猪猪侠大电影3	猪猪侠之终极决战
猪猪侠3	猪猪侠之终极决战
升天有道	我爸爸不是人
多拉斯历险	地心英雄
小熊维尼真人版	克里斯托弗·罗宾
小熊维尼	克里斯托弗·罗宾
维尼与我(港)	克里斯托弗·罗宾
挚友·维尼(台)	克里斯托弗·罗宾
疯狂的年兽	年兽大作战
旋转姻缘	迟来的祝福
新战狼	战狼2
新战死沙场	战狼2
黑手	初来诈盗
大老作家(港)	你能原谅我吗？
英雄安重根	义士安重根
獨一無二	独一无二
一個角落	一个角落
百夜鬼行	不可饶恕
飞霜	冲天火
天火	冲天火
天空一号	冲天火
美人鱼公主之海盗来袭	美人鱼之海盗来袭
我的少女時代	我的少女时代
侠隐	邪不压正
法拉利传	法拉利
恩佐·法拉利	法拉利
暗渡陈仓	大汉风之暗度陈仓
暗夜战神	美女总裁的贴身高手
马克的异乡世界(台)	欢迎来到马文镇
马文科尔	欢迎来到马文镇
良心账	老吴的账单
事件末(台)	事件尽头
爱上缺角族(台)	缺角一族
未知人生	夏威夷之恋
影.怨	恐怖将映
极速狂奔	锦绣前程
屍憶	尸忆
冥婚	尸忆
蜘蛛侠：新纪元	蜘蛛侠：平行宇宙
蜘蛛人：新宇宙(台)	蜘蛛侠：平行宇宙
蜘蛛侠：跳入蜘蛛宇宙(港)	蜘蛛侠：平行宇宙
蜘蛛侠：平行世界	蜘蛛侠：平行宇宙
逆转之日	惊天大逆转
出线	惊天大逆转
元帅的童年	沉默的马鞍
灵渡凶间(港)	千次伤我心
法国式恋爱	钢板咏叹调
给女儿的爱	给女人的爱
超级玛丽遇上早高峰	早高峰之战
厉鬼电影院	惊魂电影院
眉眼盈盈处	独奏交响
曾雍雅智斗阿部规秀	诱狼
早点回家，别太晚2	诡变迷途
失控	失控·幽灵飞车
校园疯骚史·舞动青春	校园疯骚史之舞动青春
天亮分手	天亮·分手
赛尔号5	赛尔号大电影5：雷神崛起
昆塔2	昆塔：反转星球
反转星球	昆塔：反转星球
花落	花落梦深处
咔兔	超能兔战队
超能兔第一部	超能兔战队
黑土地上的最后一战	战火中的芭蕾
天鹅	战火中的芭蕾
他没有两个老婆	恋爱排班表
职场菜鸟指南	一路向前
美满人间	美好的意外
美好人生	美好的意外
再见我们的时间	再见我们的十年
爱情调味包	再见我们的十年
郁闷的画家	在劫难逃
龙门驿站	龙门驿站之嚎月
鹰之路	完全的爱
石器小英雄(台)	无敌原始人
超级无敌世界波(港)	无敌原始人
早期人类	无敌原始人
张振讲故事之鬼迷心窍	张震讲故事之鬼迷心窍
张震讲故事大电影	张震讲故事之鬼迷心窍
灭。境(港)	湮灭
灭绝(台)	湮灭
遗落的南境1：湮灭	湮灭
妈妈，别哭	妈妈别哭
梨花盛开的故乡	梨树花开的地方
基于性别	性别为本
以性为本	性别为本
战神戚继光	荡寇风云
荡寇	荡寇风云
太陽的孩子	太阳的孩子
蘋果的滋味	苹果的滋味
巴啦啦小魔仙3	巴啦啦小魔仙之魔箭公主
黎巴嫩1982: 亡命救参(港)	贝鲁特
高压行动(台)	贝鲁特
高压线上	贝鲁特
亲，别怕之鬼宅凶灵	亲，别怕
亲，别怕3D	亲，别怕
镜·双城	镜：双城
镜双城	镜：双城
双城	镜：双城
舞鬥	舞斗
都嘟-半岁特别节目	都嘟一夏特别节目
菜鳥	菜鸟
小猪班纳之梦想大“帽”险	小猪班纳大电影之梦想大“帽”险
小猪班纳之梦想大冒险	小猪班纳大电影之梦想大“帽”险
致命邂逅	活死人事件
超级兵王混都市	终极兵王
面魔	人皮拼图
村官儿	花满佟家峪
大黄蜂大电影	大黄蜂
大黄蜂独立电影	大黄蜂
变形金刚外传：大黄蜂	大黄蜂
变形金刚外传大黄蜂	大黄蜂
我最好朋友的婚礼中国版	我最好朋友的婚礼
情人湖	情人潮
回家2016	走出大墙的人之回家
西游新传2：真心话大冒险	西游超级粉
对不起，我的最美女老师	唤醒
愛情算不算	爱情算不算
大桥头的恋爱梦	爱情算不算
台北爱情捷运系列电影	爱情算不算
老人、孩子和外国人	老人、小孩和外国人
风云小棋王4	风云小棋王之解杀反捉
决战蹴鞠	蹴鞠
剑侠情缘	圣剑
极速绯闻	外公芳龄38
超速绯闻	外公芳龄38
非常主播	外公芳龄38
非常主播中国版	外公芳龄38
我在峰峰遇见你之梦	梦
盲道	盲·道
盲流	盲·道
申命記	申命记
侏罗纪世界：殒落国度(台)	侏罗纪世界2
侏罗纪世界：迷失国度(港)	侏罗纪世界2
侏罗纪世界2：失落王国	侏罗纪世界2
侏罗纪世界2：堕落王国	侏罗纪世界2
侏罗纪公园5	侏罗纪世界2
女神期间	女神时代
红骷	红髅
京城红髅	红髅
新修女也疯狂	修女也疯狂
我的狐朋狗友	我的“狐朋狗友”
太极鼠之镖飙彪	镖飙彪
催命符	催命符之劫后重生
双重約會	双重约会
雪女传说	霸道总裁别惹我
牵过你的黑发的我的手	爱情魔发师
北美小鹿猎人传奇(台)	白尾鹿猎手的遗产
黑家洼	四妹子
风云小棋王3：五行杀阵	风云小棋王之五行杀阵
蒲出去2：皇者之阶	蒲出去2之皇者之阶
西游外传：终结篇	西游外传2
無雙	无双
追龍	追龙
卧虎2	追龙
跛豪	追龙
月色撩人	夜色撩人
坚不可摧	走出尘埃
婚前合约	合约男女
A测试之爱情大冒险	A测试
极致追击：龙凤劫	极致追击
极悍巨鲨(港)	巨齿鲨
麦格	巨齿鲨
霸海妖姬	海盗与魔女
怒海沉尸	海盗与魔女
远古大帝·大舜传奇	轩辕剑传奇
小鸡叫叫和他的朋友们	小鸡叫叫
叫叫和他的朋友们	小鸡叫叫
末日困兽战(港)	狂暴巨兽
毁灭大作战(台)	狂暴巨兽
狂暴：世纪浩劫	狂暴巨兽
狂暴	狂暴巨兽
怪兽大破坏	狂暴巨兽
沒女神探	没女神探
部部惊心	部部惊心之车祸人妻
2 卫青	百家讲坛：中国故事·爱国篇
3 霍去病	百家讲坛：中国故事·爱国篇
拳力逃脱(台)	22英里
绝地22哩(港)	22英里
鬼新娘	诡新娘
其主之声	造主之声
大顺1927	大顺·1927
大顺·一九二七	大顺·1927
冥童	白云桥
江南灵异录之白云桥	白云桥
灵魂的温度	男人制造
怨相	恐怖照相机
青春激荡的年代	青春激荡的岁月
擦出爱火花	摄男斗女模
捉妖济4：归来	捉妖济
新捉妖济	捉妖济
红旗袍	恐怖禁忌之红旗袍
盗爱	等爱归来
老大 老板	民工
寻梦	彝乡情梦
传世宝藏	侠骨豪情
头七艳情	诡影迷情
新柳堡的故事	柳堡的女人们
章镇讲诡故事	午夜讲诡故事
张震讲诡故事	午夜讲诡故事
胜利十一人	笑林足球
麦兵兵	麦兵兵之夺宝联“萌”
道士出山3：阴阳先生	阴阳先生
高大人生	太空生活
最后的十八梯	十八梯184号
梨花白	桃花红
我的盖世英熊	我的盖世男友
所以，我和黑粉结婚了	所以……和黑粉结婚了
于是我和Anti-fan结婚了	所以……和黑粉结婚了
萌系检察官之正好的我们	正好的我们
那些年，那些女人	那些女人
十年	南方
浣花洗剑录电影版	情剑
燈塔下的戀人	灯塔下的恋人
奋斗与爱情	都市迷踪之性本善
浴火凤凰之钢管女郎	浴火凤凰
我是大熊猫2之熊猫大侠	我是大熊猫之熊猫大侠
梦回甲午	大变局之梦回甲午
不敢上床的女人	命中住定
真爱趁现在(台)	午夜阳光
日出前让恋爱开始(港)	午夜阳光
美版《太阳之歌》	午夜阳光
老公要上位	老公大作战
抠门大师	抠门大师
抠门师傅	抠门大师
中国英雄联盟之钢管侠	钢管侠
神秘的洛克	痞子·洛克
深圳往事	青湖
讨学钱	张学生讨学钱
《红楼梦》大观园与清代园林艺术	百家讲坛：大观园与清代园林艺术
回头路	诡梦凶铃
绑架郭德纲之狗仔岁月	绑架郭德纲
灵探理柯南	脱线灵探理柯南
脱线灵探	脱线灵探理柯南
《默·忆》	默·忆
典藏故事	典藏的故事
引爆點	引爆点
特卫俏佳人	贴身俏保镖
裸情恨电影版	风流小姨子
阿罩霧風雲II-落子	阿罩雾风云2落子
阿罩雾II	阿罩雾风云2落子
紅衣小女孩	红衣小女孩
同样的爱	霸道总裁和他的男人
死侍往事	死侍2
山花烂漫	山花烂漫时
氧气美女	夜闯寡妇村
暗洞惊魂	诡劫
九层妖楼	诡打墙
鬼打墙	诡打墙
猎爱北京	追爱北京
我們全家不太熟	我们全家不太熟
三个逊爸一个妈	我们全家不太熟
终极赌王	赌神归来
美女校花的贴身高手	校园仙侠传
八卦女王	帕帕拉奇
笔仙惊魂4	笔仙魔咒
新笔仙惊魂	笔仙魔咒
2014年春晚	2014年中央电视台春节联欢晚会
何延川之一九四六	何延川之1946
千里心行	邕江之恋
归心四贱	回乡逗儿
以愛為名	以爱为名
舒克与贝塔	舒克和贝塔
舒克和贝塔电影版	舒克和贝塔
舒克与贝塔电影版	舒克和贝塔
毕业旅行	毕业旅行笑翻天
和她的五天四夜	夜店公主擒爱记
超萌特攻队	长江7号：超萌特攻队
长江7号动画大电影：超萌特攻队	长江7号：超萌特攻队
长江七号超萌特工队	长江7号：超萌特攻队
西城童話	西城童话
台北爱情捷运系列电影	西城童话
西游·紫霞篇	紫霞
孙悟空的女友	紫霞
真假猴王之大圣归来	紫霞
Studio homicide case（英）	画沙
毛驴县令2之非我莫属	毛驴县令之非我莫属
那年他十七岁	那年他17岁
姐妹兄弟	希斯特斯兄弟
淘金杀手	希斯特斯兄弟
新版狼牙山五壮士	狼牙山五壮士
狼牙山五壮士3D	狼牙山五壮士
狼牙山伍壮士	狼牙山五壮士
· 階級兄弟	順民刁民
风信有约	寄往昙华林78号的明信片
iGirls梦情人(港)	我的极品女神
我的极品女友	我的极品女神
我的智能女友	我的极品女神
淘得有情人	我的极品女神
魔女的童话	魔女
阿鸡米德作弊	你好鸡智：集体作弊事件
你好鸡智01集：集体作弊事件	你好鸡智：集体作弊事件
迷途杀机	绑架者
兇手還未睡	凶手还未睡
红楼梦与北京王府	《红楼梦》与北京王府
国宝档案：《红楼梦》与北京王府	《红楼梦》与北京王府
张震讲诡故事2	午夜讲诡故事2
红楼梦与王府抄本	《红楼梦》与王府抄本
国宝档案：《红楼梦》与王府抄本	《红楼梦》与王府抄本
長安，長安	长安，长安
欲望之偷窥	偷窥大师
探灵档案电影版	探灵档案
盲点侦探	探灵档案
天使的收音機	天使的收音机
青春躁郁	愤怒
幸福路上动画电影版	幸福路上
南口一九三七	南口1937
毒。誡	毒。诫
神行太保	毒。诫
陈华传	毒。诫
半条命1：美女总裁与特种兵	美女总裁与特种兵
日本投降	受降前夕
母亲的承诺	额吉的承诺
共和国反腐枪声	反腐枪声
极限挑战大电影	极限挑战之皇家宝藏
极限挑战之圣火令	极限挑战之皇家宝藏
最后的武士	极限挑战之皇家宝藏
爱情包邮	那件疯狂的小事叫爱情
寻龙笔记之阴阳墓	猛鬼吹灯之寻龙决
阴阳墓	猛鬼吹灯之寻龙决
寻龙决	猛鬼吹灯之寻龙决
犧牲之旅	牺牲之旅
十六公里長的夜	十六公里长的夜
妄想症之骇案三奇	妄想症
鬼遮眼之道长出马	鬼遮眼
致命诱惑	泡上美女总裁3
迷你星	危险游戏
鬼压床	狗眼看阴阳之帝王香包
纪念日(港)	分手再说我爱你
整容液事件	整容液事件1
新欢乐满人间	欢乐满人间2
魔法保姆(港)	欢乐满人间2
爱·满人间(台)	欢乐满人间2
蛛网	谜巢
蛛巢	谜巢
出遊	出游
森林眼睛	天降(梅新执导)
第一季	名声大震
因爱而生	克隆女友
仙剑客栈大电影	仙剑客栈
鴨王2	鸭王2
鸭王2：鸡同鸭恋	鸭王2
色模	星探
花开的声音	耳蜗
妈妈让我再爱你一次	妈妈，让我再爱你一次
偷心	天机
猎鹰	非凡任务
我的青春我点赞	青春逗
为青春点赞	青春逗
南京东	南京东1937
童梦成真 哆啦A梦真人版大电影	拜托了小叮当
盗墓之逗	盗墓奇遇记
上身	心惊胆战
3 恐ろし山の亡霊番長	ヒロミくん!
疯狂的初夜	疯狂的夜
怒火边界2：毒刑者(台)	边境杀手2：边境战士
毒裁者2：无法无天(港)	边境杀手2：边境战士
边境杀手2：战士	边境杀手2：边境战士
边境杀手2：兵凶战危	边境杀手2：边境战士
边境杀手2：并肩作战	边境杀手2：边境战士
争宠(港)	宠儿
真宠(台)	宠儿
宠姬	宠儿
挚爱	宠儿
南极绝恋	南极之恋
莫日根：人熊大战	莫日根
暗夜之狼(台)	黑暗杀机
持有黑暗	黑暗杀机
手持黑暗	黑暗杀机
一家老小向前冲电影版	一家老小向前冲
异性合租	异性合租的往事
与异性合租的往事	异性合租的往事
鬼灵精怪大酒店3：怪兽旅行团(港)	精灵旅社3：疯狂假期
尖叫旅社3：怪兽假期(台)	精灵旅社3：疯狂假期
年三十的班车	班车惊魂
失控謊言	失控谎言
徐州爷们	爷们
葛优——“编辑部”里走出来的黄金搭档	档案：冯小刚
雖然媽媽說我不可以嫁去日本	虽然妈妈说我不可以嫁去日本
ママは日本へ嫁に行っちゃダメと言うけれど。	虽然妈妈说我不可以嫁去日本
云在故乡等我	矮婆
番外篇 终极之战	极限挑战
禁室逃杀	监禁风暴
蚁侠2：黄蜂女现身(港)	蚁人2：黄蜂女现身
蚁人2	蚁人2：黄蜂女现身
蚁人与黄蜂女	蚁人2：黄蜂女现身
红拳虎娃	关中红拳
在世界的中心呼唤爱	奔爱
爱，无处不在	奔爱
呼吸	你在哪
春嬌救志明	春娇救志明
志明与春娇3	春娇救志明
飞鸢	闭嘴！爱吧
飞燕	闭嘴！爱吧
港片少年	香港武打片
小狗岛	犬之岛
汪星人之岛	犬之岛
犬ヶ島	犬之岛
海風	海风
远山	三抬镇
妖夜荒踪	荒村凶间
七月半2	七月半2：前世今生
七月半之前世今生	七月半2：前世今生
变身计之长大了	变身计
恶人	暴裂无声
寻山	暴裂无声
山野追踪	暴裂无声
草木之恋-情定旧金山	草木之恋
咖啡	咖啡风暴
晚五朝九(台)	五到九
彼得兔	比得兔
末世异种(台)	超能泰坦
泰坦	超能泰坦
狙击唐小婉	禁忌关系
恶之花	禁忌关系
屌丝侠	屌丝侠之欲望之门
新人勿近	与人为恶
暗算(台)	与人为恶
海岸救援队之食人海怪	海滩救援队之食人海怪
翻译官电影版	翻译官
反斗天庭2	反斗天庭之特种部队
宝贝别闹之地库婴啼	地库婴啼
女版十一罗汉	瞒天过海：美人计
瞒天过海：八面玲珑(台)	瞒天过海：美人计
盗海豪情：8美千娇(港)	瞒天过海：美人计
八罗汉	瞒天过海：美人计
八大罗汉	瞒天过海：美人计
侠盗英姿	瞒天过海：美人计
盗海姐妹团	瞒天过海：美人计
华尔街狼群(港)	亿万少年俱乐部
亿万男孩俱乐部(台)	亿万少年俱乐部
大智若愚	亿万少年俱乐部
亲爱的初恋(台)	爱你，西蒙
抱抱我的初恋(港)	爱你，西蒙
西蒙和他的出柜日记	爱你，西蒙
爱你的西蒙	爱你，西蒙
爱，赛蒙	爱你，西蒙
太空熊猫3	太空熊猫英雄归来
天师伏魔第一章觉醒	天师伏魔之觉醒
电影《画》	画
恐怖快件	恐怖快递
爱情速递	恐怖快递
硬颈仔	活着
难得有情人	奔跑吧有情人
末日恋人	末日情人节
蜘蛛网里的女孩	蜘蛛网中的女孩
龙纹身的女孩续集	蜘蛛网中的女孩
阿鸡米德表白	你好鸡智：真诚的付出
你好鸡智02集：真诚的付出	你好鸡智：真诚的付出
二十八岁未成年	28岁未成年
电影版我和春天有个约会	我和春天有个约会
吉诺密欧与朱丽叶2	淘气大侦探
神探福尔摩侏(港)	淘气大侦探
糯尔摩斯(台)	淘气大侦探
吉诺密欧与朱丽叶2：夏洛克·糯尔摩斯	淘气大侦探
暴走兄弟大战僵尸古惑仔	暴走兄弟VS僵尸古惑仔
后座有诡	暴走兄弟VS僵尸古惑仔
Z计划	抢红
完全男生手册	脱单告急
他爸的奇幻人生	脱皮爸爸
荷尔蒙	燃烧吧
叛逆的青春	燃烧吧
末日归途	丧尸屠城
怨灵死咒之404室	怨灵死咒
夕阳山外山	弘一法师
启程之前	不肃之客
偷天特务(港)	王牌逗王牌
盗中盗	王牌逗王牌
爱上贼中贼	王牌逗王牌
前任3	前任3：再见前任
前任攻略3	前任3：再见前任
前任3：颜值大作战	前任3：再见前任
伪装者电影版	伪装者
京城81号Ⅱ	京城81号2
赌王之王	山炮赌王
外星古墓	道士出山3：外星古墓（上）
钟楼怪人真人版	艾丝美拉达
钟楼驼侠真人版	艾丝美拉达
围鸡总动员(台)	护航父母
反啪啪同盟(港)	护航父母
护航者	护航父母
倩女箫魂	箫魂传之倩女箫魂
瓯柑之味	瓯柑之恋
致命倒数	逆时营救
闺房秘影	凄灵室
泡妞36计	泡妞三十六计
十七要不要	校花驾到2蜜桃时代
重踏舞姐妹会(台)	辣舞姐妹
街舞姐妹	辣舞姐妹
命运谷	命运谷之决胜宜昌
得闲谨制	命运谷之决胜宜昌
阿公教你看布袋戲	阿公教你看布袋戏
校囧	恋上女教师
天使嘎丽娅	冰美人
和平天使嘎丽娅	冰美人
捉妖济Ⅲ人鬼殊途	捉妖济3人鬼殊途
前戏	外星人来了之前戏
江湖	断肠江湖安
之前的女孩	前任女孩
废物小说大电影	东北花泽类之起幺蛾子
开心赌鬼	鬼域赌王
时光情书中国版	时光情书
美食 蟹黄包	恋爱
恋爱、美食、蟹黄包	恋爱
生命守护者	守巢人
北极	伊阿索密码
爸爸我来救你了之吉大嘿梦	爸爸我来救你了
夏天十九岁的肖像	夏天19岁的肖像
夏天，十九岁的肖像	夏天19岁的肖像
夏天，19岁的肖像	夏天19岁的肖像
中国版美女罐	美女罐
末日危机	病毒之末日危机
TV屍	TV尸
刺青杀阵	二次元侦探
女神噩梦	朋友圈噩梦
恶梦天使	朋友圈噩梦
夜袭美人村	夜袭寡妇村
屌丝男女5	蕾丝男女·东莞之囧
梦魇人偶	诡娃
窒息空间1：绝命逃生	活埋惊魂
狼爸的神秘计划	小王子的奇幻之旅
阿成一家的幸福生活	白夜
背断厕所	白夜
大兄弟	花花子弟
老板好坏(台)	外国佬
边个出差咁黑仔？(港)	外国佬
美国运通	外国佬
摩登神探	摩登神探2015
千年御水珠 总集篇	狐妖小红娘剧场版：下沙
午休時間	午休时间
The Lunch Break（英）	午休时间
光棍奇遇记3之光棍天使	光棍奇遇记3
爱情公社	同城邂逅
大变话	谎言大爆炸
完美女神进化论	绝色少女变身记
徐州兄弟之百万富翁	疯狂兄弟
腿哥！别停	腿哥别停
锁龙井	诡异录之锁龙井
神精榜	聚精会神榜
他們在島嶼寫作：讀中文系的人	他们在岛屿写作：读中文系的人
麻辣白玉堂之双龙会	麻辣白玉堂之致命棋局
阴阳实录之红衣男孩	红衣男孩
愛造飛雞	爱造飞鸡
泡妞大宗师	泡妞大宗师之老泡儿
他們在島嶼寫作：1918	他们在岛屿写作：1918
天网窥欲	艳遇也疯狂
隔离岛	毕业作品
夏沫特烦恼	夏沫的白日梦
少林小神童	大寺神童
左魔传：五勇士	左魔传
金编钟之谜	金编钟传奇
疯狂系列之粤囧	粤囧
美人鱼前传	海女奇缘
捉妖者联盟II	捉妖者联盟2：大圣娶妻
古祸仔之重出江湖	导演不让说
古祸仔	导演不让说
大祭司传奇	极品小农民
心理罪大电影	心理罪
圣女脱单记	剩女脱单记
唐探2	唐人街探案2
朝阳群众	王牌碟中谍之朝阳群众
王牌碟中谍I：朝阳群众	王牌碟中谍之朝阳群众
小炮儿闯江湖	小炮儿之三傻大劫案
斯诺克之台球帝国	斯诺克
離家出走自己友	离家出走自己友
魔都魅影	通灵魔镜
無題（舞伴）	无题（舞伴）
遇上神仙的奇幻基夜	遇见神仙的奇幻基夜
与上帝在一起的夜晚	遇见神仙的奇幻基夜
变性吧！咪咪的大公鸡	遇见神仙的奇幻基夜
不可思议的旅行	遇见神仙的奇幻基夜
我老婆係明星	我的老婆是明星
我老婆是明星	我的老婆是明星
茉莉的牌局	茉莉牌局
决胜女王(台)	茉莉牌局
莫莉游戏(港)	茉莉牌局
一念無明	一念无明
點五步	点五步
白人男孩里克	白人男孩瑞克
吃饭睡觉打豆豆大电影	豆福传
豆仙	豆福传
萌娃囧爸	小爸小妈
阴灵双子大战	你别吓唬我2之阴灵双子
你别吓唬我2阴灵双子	你别吓唬我2之阴灵双子
危情绑架	匪闻
魂兮归来	死亡别墅
饿棍天使	炮神归来
僵尸来了	僵尸来了之伏魔夜
自畫像	自画像
切小金家的旅館	切小金家的旅馆
切小金的旅馆	切小金家的旅馆
痴情男子漢	痴情男子汉
爱情大师的秘密行动	痴情男子汉
順雲	顺云
女人与不能决定的事	顺云
奎迪2	奎迪：英雄再起
金牌拳手：父仇(台)	奎迪：英雄再起
金牌拳手2	奎迪：英雄再起
洛奇8	奎迪：英雄再起
克里德2	奎迪：英雄再起
青春星主播	青春星主播之我的个女神啊
盗钥匙的方法中国版	盗钥匙的方法
任意依恋中国版	任意依恋
斗地主传奇	斗地主传奇之双王之王
移动花房	移动的花房
貂蝉大战丧尸	四大美人之貂蝉大战丧尸
弄潮时代	风口青春
阿良的长征	长征之路
第26屆台灣金曲獎頒獎典禮	第26届台湾金曲奖颁奖典礼
第26届台湾金曲奖	第26届台湾金曲奖颁奖典礼
蛇从革日记之东泉宾馆	蛇从革日记
啪啪啪	睡衣趴papa
大妈万岁	哈啰大妈
斯坦与奥列佛	斯坦和奥利
锋味江湖之决战食神	决战食神
锋味江湖	决战食神
美食之王	决战食神
没有刹车	一帮坏家伙
玛瑞塔	玛丽塔
大手牽小手	我的妈呀
半条命2之刺杀美女总裁	半条命2：刺杀美女总裁
小医神	绝世医仙
梦断巫山	巫山一夜
网络惊魂之激情视频の诅咒	网络惊魂
变性玛丽苏	韩咪咪小姐变身计
古镇悬案	养魂计划
六度空间	黑暗迷宫
爆笑神汤	美人鱼汤
山里的石头	老师再爱我一次
導火新聞線	导火新闻线
机器人Igirl	Igirl养成手册
养成机器人女友	Igirl养成手册
简单爱	奇葩朵朵
彩虹伴我行	彩虹老爸
东北特工007	东北特工吴老二
寻找女神娇阿依	寻找女神@娇阿依
寻找女神·娇阿依	寻找女神@娇阿依
零体	断头台
仁和闪亮新主播——主持人全国选拔大赛	闪亮新主播
報告老師！怪怪怪怪物！	报告老师！怪怪怪怪物！
修潇楠	成人玩家
女神精之女神日志	女神精之女神日记
酒惊、酒经	断片儿
酒惊酒经	断片儿
太白遗凤	断片儿
科莱特	柯莱特
花都教主柯蕾特(台)	柯莱特
抹大拉的马利亚(台)	抹大拉的玛丽亚
耶稣的女门徒(港)	抹大拉的玛丽亚
抹大拉的玛利亚	抹大拉的玛丽亚
2014年北京卫视春节联欢晚会	2014年北京电视台春节联欢晚会
阿爸的西米囉	阿爸的西米啰
24小时生存	24小时：末路重生
一日求生	24小时：末路重生
只活24小时	24小时：末路重生
金玉良缘	金星和她的朋友
泡妞之王	泡王
车祸灵异事件	心灵救赎
那一夜	心灵救赎
酒惑	心灵救赎
酒祸	心灵救赎
天津恐怖故事	天津恐怖事件
人小鬼大(2015)	人小鬼大
半人半鬼	半人半鬼之女鬼上床
终极杀人魔	唐人街杀人魔
唐人街命案	唐人街杀人魔
杀讯2(台)	解除好友：暗网
解除好友2	解除好友：暗网
我欲振翅	僚机
飞行员的故事	僚机
两个爸爸(台)	理想之家
理想家庭	理想之家
北京台春晚	2016年北京电视台春节联欢晚会
2016猴年北京卫视春晚	2016年北京电视台春节联欢晚会
敬礼！检察官	敬礼检察官
地狱恋人	风中有朵雨做的云
地狱情人	风中有朵雨做的云
阮郎歸	阮郎归
念儿归	阮郎归
12小时	虐杀12小时
傻瓜向錢衝	傻瓜向钱冲
一路撞鬼	套套侠
建群大业	建群囧事
城管大战美人鱼	超能人鱼
美人鱼2016	超能人鱼
三休之火星归来	火星归来
八戒降妖	西游记八戒降妖
有五個姊姊的我就註定要單身了啊！！	有5个姐姐的我就注定要单身了啊！！
有五个姐姐的我就注定要单身了啊	有5个姐姐的我就注定要单身了啊！！
五个姐姐	有5个姐姐的我就注定要单身了啊！！
接線員	接线员
与青春化敌为友 終極舞班	十七后
十七岁	十七后
终极舞班	十七后
青春的你	十七后
悄然走进你的世界 电影版	情骚
古墓女友	沉睡千年的古墓女友
锁妖塔	西游记之锁妖封魔塔
2016江苏荔枝元宵包袱铺	2016江苏卫视元宵晚会
击毙大狸砸	绑架王公子
新开心鬼2：欢天喜地开心鬼	欢天喜地开心鬼
2016湖南卫视元宵喜乐会	元宵喜乐会
2016元宵喜乐会	元宵喜乐会
进击吧！单身狗	进击吧单身狗
异梦空间	穿越者之异梦空间
春琴抄	春琴传
美好合一2016·大师微电影	美好合一2016
营生+住在幸福大街的王大妈+在镰仓+是这样的	美好合一2016
影子猎人：我的白天她的夜	影子猎人
影子猎人之血灵契约	影子猎人
焦点疑犯	特殊嫌疑犯
旁观者	无眸之杀
谍血二中1：首长的阴谋	谍血二中
小美人鱼真人版	小美人鱼
阿里巴巴：所罗门封印	阿里巴巴2所罗门封印
中国版东京爱情故事	东爱
爱在蟹逅时	爱的蟹逅
爱的邂逅时	爱的蟹逅
扑通扑通花少年	扑通！扑通！花少年
听见·爱	听见爱
奇门遁甲2015	奇门遁甲
鬼来了	逗逼
逗逼，鬼来了	逗逼
愤怒的校花	愤怒的校花之高校惊魂
第52屆金馬獎頒獎典禮	第52届金马奖颁奖典礼
第33屆香港電影金像獎頒獎典禮	第33届香港电影金像奖颁奖典礼
第34屆香港電影金像獎頒獎典禮	第34届香港电影金像奖颁奖典礼
第35屆香港電影金像獎頒獎典禮	第35届香港电影金像奖颁奖典礼
胡桃夹子(港)	胡桃夹子和四个王国
胡桃钳与奇幻四国(台)	胡桃夹子和四个王国
胡桃夹子真人版	胡桃夹子和四个王国
第三季	中国谜语大会
2016中国谜语大会	中国谜语大会
一克拉的承诺	疯狂的戒指
失眠	再见城市
生化奇兵之丧尸新娘	生化奇兵之血洗尸巢
大樓有鬼	大楼有鬼
夜襲	夜袭
下錨	下锚
天使驾到	天使驾到之一夜精喜
追爱大冒险	我大学室友的追爱囧途
鬼吹灯之云南虫谷	云南虫谷
愛在南潯	爱在南浔
校园特工	混世高校
遊戏规则	游戏规则
人鱼之恋	钓神
魔力耳环	猪妖记
杀无赦	东北古惑仔之杀无赦
东北古惑仔	东北古惑仔之杀无赦
猎灵师之镇魂石	猎灵师
狂獸	狂兽
今晚打喪屍	今晚打丧尸
喵	喵星人
正中午的太阳、正义与强权间较量	太阳当空照
网络女主播	网络女主播之迷局
脑囧之我不是范冰冰	脑囧
拆弹·专家	拆弹专家
隐之爱人	借眼
你好机智第四集	你好鸡智：校园魅影
中国药神	我不是药神
印度药神	我不是药神
印度药商	我不是药神
生命之路	我不是药神
中国版少年时代	成长
逆向誘拐	逆向诱拐
分裂	分裂1:906号患者档案
这都不是事之二爷的“阵地”	这都不是事之二爷的阵地
诡宅·夜呻吟	诡宅夜呻吟
终极直播	拾九禁终极直播
19禁-终极直播	拾九禁终极直播
霸天狼	空天猎
身后仕(港)	监狱学警
我从哪里来 我要到哪里去	我是谁
我是谁 从哪里来 到哪里去	我是谁
绝世高手之料理铁人	绝世高手
萌学园之寻找磐古	萌学园：寻找盘古
许愿小灵陶	阿狸
空间魅影	迷失空间
中国版二十	二十岁
徐向前三战阎锡山	三打三捷
宠灵实验室-狸奴艾莉	宠灵实验室之狸奴艾莉
艾莉	宠灵实验室之狸奴艾莉
老大必须死	我们混过的江湖
潮囧之我的前任要结婚	我的前任要结婚
中国版捉迷藏	捉迷藏
校花驾到3人鱼校花	人鱼校花
少男时代	我的少男时代
会疼的十七岁	会痛的十七岁
会痛的17岁	会痛的十七岁
一夜东莞	夜店奇缘
一代宗师熊庆来	熊庆来
從缺	从缺
捕快：血之刃	捕快血之刃
十冷2	十万个冷笑话2
救殭清道夫	救僵清道夫
尸奔日记	救僵清道夫
肇事者	破·局
走到尽头	破·局
情人节奇妙夜	开房奇妙夜
夜魔坛	夜魔坛之女高怪谈
啪啪顺风车	心动顺风车
兄弟殊途	黑社会之兄弟殊途
罪欲·黑道风情	黑社会之兄弟殊途
出租房	欲望出租房
奶酪陷阱电影版	奶酪陷阱
建筑师故事	不要搞奇奇怪怪的建筑
奇奇怪怪的建筑	不要搞奇奇怪怪的建筑
血墙	租房惊魂之血墙
更深	越陷越深
挥着麒麟臂的女孩儿	御姐拳皇
給愛麗絲	给爱丽丝
这么近，那么远	流氓少年
铠甲勇士捕将剧场版	铠甲勇士捕王
盗梦者之血瞳	盗梦者
低俗青春2	最好的青春
邦克山：一座城、一次围攻、一场革命	邦克山
神兽金刚大电影	神兽金刚之青龙再现
解码者	解码游戏
大宋夜总汇之梦回青楼	大宋总动员之梦回青楼
六个人的电影	夺命推理
华严小镇之一诡踪	华严小镇之诡踪
华严小镇之二藏踪	华严小镇2之藏踪
E家侦探社	辣条侦探
嫦娥归来	月亮的后裔之嫦娥归来
夺面人	聊斋新编之画皮新娘
星游记网络大电影	星游记之风暴法米拉
星游记2	星游记之风暴法米拉
星游记重置版	星游记之风暴法米拉
吓死宝宝了	精灵校花
宝宝吓死了之精灵校花	精灵校花
青春正蓝之公主和她的49个男仆	青春正蓝
公主和她的四十九个男仆	青春正蓝
公主和她的49个男仆	青春正蓝
彼得潘	小飞侠
小飞侠真人版	小飞侠
彼得潘真人版	小飞侠
闪婚@七天嫁给你	闪婚之七天嫁给你
女生禁区电影版	女生禁区之灵异档案
22个男人(台)	购物女王
天堂之吻	购物女王
谜域	谜域之噬魂岭
进皇城	进京城
校恐	开学悸
校园有诡	开学悸
男神训练营	最佳男友进化论
操控者	幕后玩家
西游乱入三国2	西游乱入三国下集
心理罪·城市之光	心理罪之城市之光
城市之光	心理罪之城市之光
缉凶者	心理罪之城市之光
深流不息	谁的青春不热血之深流不息
神农溪之恋	漂洋过海来爱你
海を越えた愛	漂洋过海来爱你
快乐星球大营救	快乐星球之三十六号
快乐星球电影版	快乐星球之三十六号
快乐星球大电影	快乐星球之三十六号
云镝：丝路英雄	丝路英雄·云镝
丝路英雄之云镝	丝路英雄·云镝
初恋教我的18件事	初恋教我的十八件事
幸运红中	师生换魂
承诺	疯狂夺爱之搏击少年
最後一枝蠟筆	最后一枝蜡笔
果乐城	魔力果乐岛之拯救行动
水地球	星际大逃亡
我与世界，只差一个你	我与世界
冷杀	灵异二维码
冷杀	灵异二维码
A Woman's Gaze（英）	她的眼光
养老计划	盛先生的花儿
我的小人物	小家伙
毛骨悚然2	鸡皮疙瘩2：闹鬼万圣节
书中自有魔怪谷2： 翻生万圣节(港)	鸡皮疙瘩2：闹鬼万圣节
无限斗界	无限斗界之暗夜双龙
无限斗界之暗黑双龙	无限斗界之暗夜双龙
临界1：善恶的彼岸	临界
天使学院	天使学院的爱情战记
天使学院爱情战记	天使学院的爱情战记
汽车人总动员2	汽车人总动员2：疯狂逆袭
裸漂辣妹	辣妹魅影
52赫茲，我愛你	52赫兹，我爱你
52Hz我爱你	52赫兹，我爱你
小姐去哪了	夜色惊魂
麦客乔丹	麦克乔丹
巴喳巴喳	疯狂玩具城
奇异家族	神秘世界历险记3
特工陈先生	栋笃特工
血证1928	血证一九二八
情感师	爱情公关师
筆談情、紙說愛	笔谈情、纸说爱
魔幻微电影《天朝魔法学院》 北服建校55周年微电影	天朝魔法学院
得不到但依然爱你	得不到，但依然爱你
神秘人鱼	神秘美人鱼
致命疑云	双面疑云
替代者之情迷画皮	替代者之迷情画皮
银湖之下	银湖之底
魔胎2016	魔胎
电影版校花的贴身高手	校花的贴身高手
我的超豪男友(港)	摘金奇缘
疯狂亚洲富豪(台)	摘金奇缘
疯狂富豪(新)	摘金奇缘
疯狂的亚洲富人	摘金奇缘
疯狂的亚洲富豪	摘金奇缘
人疯钱多亚洲豪	摘金奇缘
奥菲丽娅	奥菲莉娅
江山-杜立特行动	江山：杜立特行动
热血高校之青禾男高	青禾男高
瘦人	瘦长鬼影
无面男	瘦长鬼影
斯兰达人	瘦长鬼影
奇迹	奇迹男孩
不可救药	无可救药
玛雅之石	玛雅石
一念向北大电影	一念向北之危险关系
惩罚	揍他一顿
在那遥远的地方	白天鹅
老户儿家	白天鹅
欲望森林三部曲	欲望森林
功夫机器侠之南拳	功夫机器侠
功夫机器侠·南拳	功夫机器侠
读舞其生	青春未央之舞·梦
奇爱力克斯(台)	见爱不怪
爱怪不怪	见爱不怪
打開我天空	打开我天空
拳王高校	拳皇高校
穿越吧！黄飞鸿	飞鸿囧传
破碎之地的幽灵	碎土之灵
我的老爸是男神	男神
大釣哥	大钓哥
上岸的魚	上岸的鱼
后花园	上岸的鱼
厌世妈咪日记(台)	塔利
论尽爆煲妈咪(港)	塔利
塔莉	塔利
蕾切尔·杜普瑞的个人史	蕾切尔·杜普利个人史
北极星	远方的星
机器禁室	智慧囚屋
纯真年代	赤裸青春
准备出演	演员的自我修养
江湖悲劇	江湖有道
江湖喜剧	江湖有道
江湖话事人	江湖有道
纺纱人	真相漩涡
真相旋涡	真相漩涡
我叫哀木涕之山口山战记	我叫MT之山口山战记
我叫MT之勇士战恶龙	我叫MT之山口山战记
我叫MT之“勇士”战“恶龙”	我叫MT之山口山战记
电影版我叫MT	我叫MT之山口山战记
金色先锋	黄金后援
十级风劫(港)	飓风奇劫
玩命飓风(台)	飓风奇劫
飓风抢劫	飓风奇劫
夺金风暴	飓风奇劫
五级飓风	飓风奇劫
一棵心中的“许愿树”	一棵心中的许愿树
漠视	欲望迷宫
笨妖怪	西游番外篇笨妖怪
玄笔录前传之百妖图	玄笔录前传之怨妖坛
丛林游戏第一季	丛林游戏之丛林法则
食神归来2016	食神归来
潜伏4	潜伏4：锁命亡灵
阴儿房第4章：锁命亡灵(台)	潜伏4：锁命亡灵
儿凶 第四回(港)	潜伏4：锁命亡灵
潜伏4：最后的线索	潜伏4：锁命亡灵
潜伏4：最后的钥匙	潜伏4：锁命亡灵
葉問外傳：張天志	叶问外传：张天志
张天志	叶问外传：张天志
张天志传	叶问外传：张天志
叶问外传	叶问外传：张天志
叶问系列之张天志	叶问外传：张天志
二代妖精	二代妖精之今生有幸
一代妖精	二代妖精之今生有幸
一代妖精电影版	二代妖精之今生有幸
动物管理局	二代妖精之今生有幸
妖怪管理局	二代妖精之今生有幸
禁失迷城	我的世界
女儿国奇孕记	西游记之女儿国奇孕记
爱别离	别离
母与子	别离
追梦赤子心	导演，我们不约
水果忍者大电影	水果忍者
那年的夏天	西小河的夏天
那年夏天	西小河的夏天
寒武纪	湖边密林
女士復仇	女士复仇
见习女巫	魔法学院之见习女巫
老師，你會不會回來	老师，你会不会回来
毒战赫图阿拉	毒中毒
茶宠和小机器人	阿唐奇遇
阿唐小来的奇幻之旅	阿唐奇遇
半条命之特种兵之战	半条命3：特种兵之战
我的中国心：坐在人生的边上——杨绛	坐在人生边上——杨绛
摩天大楼(台)	摩天营救
高凶浩劫(港)	摩天营救
高耸入云	摩天营救
刺客记忆 血月	刺客记忆之血月
如果青春不曾在盛夏逝去	如果青春不曾逝去
临时保镖	求职保镖
内地版古惑仔之义字当先	江湖之义字当先
直播时代	不良女主播
归	鬼宅冤灵
生死救赎	毒爱
毒爱2016	毒爱
原来李还在这里	原来你还在这里
弗爷计划	佛爷计划
提着心，吊着胆	提着心吊着胆
公共事务	朝政
国家大事	朝政
孕囧	代孕之造人日记
醉花火	醉了的爆竹
醉烟花	醉了的爆竹
驯狼纪(港)	阿尔法：狼伴归途
极地之王(台)	阿尔法：狼伴归途
阿尔法	阿尔法：狼伴归途
大护法之黑花生	大护法
绝境求生	绝境逃亡
玉坠	唐人街1871
金山	唐人街1871
屌丝求爱记	临沂车神
西湖人家	十月阳春
原来是金曲端午特辑	端午金曲捞
原来是金曲之端午特别节目	端午金曲捞
猜心大神	疯岳撬佳人
窥视情	玩命爱个姑娘
酒国英雄之摆渡人2	摆渡人2
古剑奇谭电影版	古剑奇谭之流月昭明
喜欢·你	喜欢你
男人使用手册	喜欢你
男人手册	喜欢你
你看上去很好吃	喜欢你
紀念中國城	纪念中国城
情遇百老汇	情遇曼哈顿
隔墙有眼	诡眼
舞出精彩人生	舞出人生
生日快乐，涂涂先生	晚餐吃了爸爸
情欲 伤疤 被侮辱的人	情欲，伤疤，被侮辱的人
疑惑边缘	白雾谜岸
柠檬之恋	青春日记之柠檬之恋
三少爷的贱之七日回魂	贱神三少爷
混世四猴	西游记之混世四猴
綁架丁丁當	绑架丁丁当
勒德功	拉黛贡德
地圖的盡頭	地图的尽头
黑暗深渊	黑暗之中
招魂外传	修女
鬼修女(台)	修女
诡修女(港)	修女
我的村民我的村	家园
情迷乌贼	情迷功夫
十宗罪电影版	十宗罪
殺破狼‧貪狼	杀破狼·贪狼
红土情缘	换种方式
盗墓笔记2016	不死之身
英雄本色4	英雄本色2018
臥虎潛龍	卧虎潜龙
潜龙狙击	卧虎潜龙
陈甘万岁	陈甘快跑
愛情が風邪を引く	爱情感冒
殺手與臥底的久別重逢	杀手与卧底的久别重逢
三不娶	结婚三部曲
囧西游大电影	囧西游之荒村客栈
替我老爸去相亲	替我老爸去泡妞
生于四月一日	有完没完
欲望杀人夜	行李箱里的少女
欲望杀人夜	行李箱里的少女
再见那年（网络大电影）	再见那年
哥基王子	一条叫王子的狗
日子一去不复返	去日无痕
日子一去不返	去日无痕
亲爱的大坏蛋	亲爱的独裁者
第二季	谁是你的菜
谁是你的菜第2季	谁是你的菜
站住！狗东西	站住！别跑！
极限挑战公益联欢会	极限公益联欢会
尋物少女	寻物少女
七月半3	七月半3：灵触第七感
灵触第七感	七月半3：灵触第七感
七月半之灵触第七感	七月半3：灵触第七感
囧日	囧日之东京大冒险
湖南卫视中秋之夜	2014中秋之夜
湖南卫视中秋晚会	2014中秋之夜
中秋之夜-今夜最相思	2014中秋之夜
北京祝福你奥运梦想盛典	奥运梦想盛典
亚洲之星	秀
亚洲之星	秀
全球华人年夜饭	湖北卫视全球华人年夜饭
湖北卫视春晚	湖北卫视全球华人年夜饭
Y时空传说之时空转校生	时空转校生
熊出没之奇幻空间	熊出没·奇幻空间
熊出没大电影4	熊出没·奇幻空间
熊出没4	熊出没·奇幻空间
东方卫视 一生一世跨年演唱会	东方卫视2014跨年演唱会
小时间 第一季	小时间
床下有人：异能觉醒	床下有人4：异能觉醒
床下有人3D	床下有人4：异能觉醒
爱上女蒲团	爱上夜蒲团
如果能許一個愿：紀念鄧麗君演唱會	如果能许一个愿：纪念邓丽君演唱会
生活派对	趴体生活
派对主角	趴体生活
派對人生(台)	趴体生活
2015天猫双11晚会	2015天猫双十一狂欢夜
2014东方卫视春晚	2014东方卫视春节联系晚会
霸道总裁名流秘书	霸道总裁风流秘书
重生拍档之消尸的校花	异生探
朋友万万岁	朋友万万睡
尋找張子岱	寻找张子岱
宇爱同游	宇宙有爱浪漫同游
新捉鬼敢死队2	超能敢死队2
女版捉鬼敢死队2	超能敢死队2
老九门番外之二月红	老九门番外之二月花开
上瘾	上了瘾
三号空姐	我的空姐女友
新大头儿子和小头爸爸2	新大头儿子和小头爸爸2一日成才
新大头儿子和小头爸爸2：一日成才	新大头儿子和小头爸爸2一日成才
中国国家大剧院：参孙与达丽拉	参孙与达丽拉
大赌豪2	大赌豪2之龙兄虎弟
风的追随	心的归途
人工智能	人工智能：伏羲觉醒
完全失控之殓师	殓师
媚影女特工2暗夜舞者	赤裸女特工2暗夜舞者
疯狂逆袭	疯狂猎艳
2B青年之漳南兄弟	2B青年
漳南兄弟	2B青年
德州青年	2B青年
不良青年	2B青年
特工联盟之德扑女王	德扑女王
第三个人	纸房子
碟仙之恐怖毕业照	碟仙之毕业照
開飯啦！	开饭啦！
我是英雄	击战
寻找四季的故事	北京
切勿关灯2(港)	关灯后2
鬼关灯2(台)	关灯后2
关灯以后2	关灯后2
小城布鲁斯	河滨的夏
弟弟	出去
伤	红色季节
九度空间	九度空间之濒死体验
恩德培行动(台)	火狐一号出击
航劫168小时(港)	火狐一号出击
恩德培	火狐一号出击
恩德培七日	火狐一号出击
化身博士	变身怪医
旁门左爱	旁门左爱之星座女神
人民理发师	发囧
奔跑吧裤衩	奔跑吧！裤衩
囧二神探	屌丝神探
蜜月闯入者	蜜月杀机
虐心爱情故事暑期特别版之盲少爷的小女仆	盲少爷的小女仆
破梦游戏之不醒城	破梦游戏
甲洞	痞子校草
欢乐喜剧人大电影	欢乐喜剧人
虐心爱情故事之囚爱	囚爱
黑暗面	罪大恶极
僵尸美少女	僵尸未成年
捉妖大队之校园天师	捉妖大队
老板送作堆(台)	牵线
光音	光之声
谁杀了潘巾莲2白衣神探	谁杀了潘巾莲2
罗茜	罗西
玩命剧组之主播惊魂	玩命剧组
我的电影有点儿2	我的电影有点儿二
嘿玛 Hema Hema: Sing Me a Song While I Wait	嘿玛
等待成一首歌(台)	嘿玛
在我等之时唱首歌(港)	嘿玛
赫马·赫马：我等待你为我唱的那首歌	嘿玛
嘿玛 嘿玛：在我等待之时给我唱首歌	嘿玛
毛驴县令2之赌命考官	毛驴县令之赌命考官
暗窗	骇故事之暗窗
九台小青年	什么是兄弟
绝爱	暴君画家的情人
虐心爱情故事之暴君画家的情人	暴君画家的情人
画家情人	暴君画家的情人
四大美人之昭君捉妖	四大美人之昭君捉鬼
我的男友是太监	捡个将军做男友
韩中歌谣祭	第十七届中韩歌会
西谎极落	西谎极落之太爆太子太空舱
西谎极落：来自太空舱的你	西谎极落之太爆太子太空舱
西谎极落：太爆太子太空舱(港)	西谎极落之太爆太子太空舱
西谎极落：太爆．太子．太空舱(台)	西谎极落之太爆太子太空舱
招魂(骇故事系列电影)	骇故事之招魂
招魂	骇故事之招魂
劫爱	豪门少女寂寞心
盗墓迷情之厄难王妃	盗墓迷情之千年王妃
原諒他77次	原谅他77次
重庆村十七号	重庆村17号
毛驴县令2之草鞋公主	毛驴县令之草鞋公主
毛驴县令2之打虎上山	毛驴县令之打虎上山
毛驴县令2之虎口拔牙	毛驴县令之虎口拔牙
毛驴县令2之天外来客	毛驴县令之天外来客
毛驴县令2之宛如格格	毛驴县令之宛如格格
毛驴县令2之五官争功	毛驴县令之五官争功
毛驴县令2之一奶同胞	毛驴县令之一奶同胞
横冲直撞	远行他方
梨树小青年	梨城小青年
不可抗力(第二部)	不可抗力爱上你
意许遗诺之前世今生	意许遗诺
虐心爱情故事之禁爱	禁爱
虐心爱情故事之痴爱	痴爱
柏拉图日记之JJ历险记	柏拉图日记
雪中悍刀行电影	雪中悍刀行
刀锋·红海行动	红海行动
歌声离我远去	芳华
男極探射燈	男极探射灯
香港无厘头事件	男极探射灯
灵魂	灵魂脱壳
阴阳画师I	阴阳画师
魕異	魕异
虐心爱情故事之隐爱	隐爱
虐心爱情故事之新娘	新娘
模兽世界	危险的爱2016
活得精彩，死得漂亮	享乐人生
送祸上门	玩命直播
附身女友	X空间女友
天煞重炮(港)	同族
家族	同族
亲戚	同族
形影佳人	倩影伊人
她只是一道掠影	倩影伊人
食色	疯狂的食神
我是传奇 第二季	我是传奇2
人吓人	惊悚九部曲
末世生化之入侵	末世生化·入侵
超级奶爸	夜蒲之奶爸总裁
九尾猫之降魔狼妖	九尾猫·仙逆
G20杭州峰会文艺晚会：最忆是杭州	最忆是杭州
哈雷哈雷	浮世千
父亲最后的选择	捐赠者
穿过半个地球去睡你	穿越半个地球爱上你
穿越半个地球去爱你	穿越半个地球爱上你
爱的天空之一声所爱	一声所爱
悟空后传	悟空，悟空
野蛮生长	抵达之谜
灭绝入侵(台)	灭绝
永生之书1白房间	永生之书之白房间
时光偷渡少女	时空偷渡少女
悟空传动画电影	悟空传
魔环之逆行未来	逆行未来
魔幻之逆行未来	逆行未来
喜剧总动员之三个孬家伙	三个孬家伙
浮茶半夏	T台魔王
我是超模	T台魔王
宝贝当爹	废柴老爸
星座啪啪啪之防水逆联盟	防水逆联盟
她她她	她她她之男人靠边站
黑8传说	爆橘
清明上河图VR影片	清明上河图
失戀日	失恋日
鲁妹席艾拉(台)	塞尔拉·伯格斯是废柴
席艾拉正废柴(港)	塞尔拉·伯格斯是废柴
樱劫	那年夏天你去了哪里
直到永远	总是
我的幽灵女友	幽灵环之我的幽灵女友
盲宅	盲宅异梦
欲爱女主播	不要叫我潘金莲
新娘的告白	不要叫我潘金莲
东北娘们	东北娘们儿
西游之西梁女国	西游记之西梁女国
北京恶棍	恶棍英雄
袭击泳装女郎	追杀！林小姐
闷骚女大劫案	追杀！林小姐
雾光巴黎	暮光·巴黎
暮光巴黎	暮光·巴黎
老虎	拳王猛虎
渣男鉴定事务所	滚蛋吧！渣男
从前有个套	套住青春
明日	明天
IDOL星主播	e间客栈
天幕行动	雇佣兵
捉妖学院之闪影归来	捉妖学院
送子观音	天使报喜
谁的青春不留白	女神的诱惑：致命陷阱
媚影女特工3双生宿敌	赤裸女特工3太阳的后裔
阴阳镖师	黄泉阴镖
潘金莲之莲香西欲	莲香西欲
少年林则徐	少年有梦之初战毒魔
欲尘	欲城
喵酱大人	猫妖传奇
豪门少爷的宠物情人	猫妖传奇
识色幸也	识色，幸也
朱狼狗	血狼犬
風景	风景
致命潜能之毁灭性交易	致命潜能
背包里的潘多拉	欲界
断片儿	断片之险途夺宝
当我们初次相遇	重返初遇之夜
1986长江漂流	乘龙而行
暮夜传说之嗜血男宠	暮夜传说
总裁在上我在下	总裁在上1：初见初念
傻儿司令（2016）	新傻儿司令
另约时间	另一个时间
跨越時空的愛人(台)	另一个时间
和尚进城之紫玉金鉢	和尚进城
天缘·纳木措	天缘纳木措
佛陀转世	前世今生
生死一剑 Thunderbolt Fantasy 生死一劍	霹雳奇幻
霹雳幻想 生死一剑	霹雳奇幻
Thunderbolt Fantasy 东离剑游纪 外传	霹雳奇幻
百变护卫·送枪	送枪
与爷爷开战	祖父大战
穿过黑夜	冥王星时刻
黑暗传	冥王星时刻
小貓巴克里	小猫巴克里
天網聯盟	天网联盟
小戏骨之白蛇传	小戏骨：白蛇传
小戏骨：白蛇传篇	小戏骨：白蛇传
魏晓波给我示范过的三种歎气方式	魏晓波给我示范过的三种叹气方式
後來怎麼了	后来怎么了
热血高手2	法律之上2
赤手威龙2	法律之上2
蘋行世界之程人	苹行世界之程人
小戏骨之焦裕禄	小戏骨：焦裕禄
你好，霸王龙	你好霸王龙
你好，提拉诺	你好霸王龙
異能機友の東京龍珠	异能机友之东京龙珠
有些是习惯	有些是回忆
Dance Of Life（英）	桃子
推理笔记电影版	推理笔记
推理笔记之拉普拉斯妖	推理笔记
梦幻女儿情	西游外传之唐僧娶亲
小戏骨之白毛女	小戏骨：白毛女
西游记之红孩儿	小戏骨：西游记之红孩儿
小戏骨：西游记红孩儿篇	小戏骨：西游记之红孩儿
小戏骨之花木兰	小戏骨：花木兰
小戏骨：花木兰篇	小戏骨：花木兰
乐团惊魂夜	翻唱版本
鱼藏剑	八仙传之钟离戏土豪
那些年	我们那些年
主播公会	主播军团1：主播公会
覇王 凶血の系譜	覇王~凶血の系譜~
演技派	吾爱演技派
奇迹的赛季(台)	奇迹赛季
僵尸先生和校花！	僵尸先生与校花
星运里的错中国版	星运里的错
恋恋北京	恋恋北京情
赌神归来2黄金赌城	赌神归来之黄金赌城
大圣3036之机甲悟空	大圣3036：机甲悟空
蝴蝶效应之重新启动	蝴蝶效应：重新启动
蝴蝶效应4：重新启动	蝴蝶效应：重新启动
唐伯虎之换性奇缘	唐伯虎之幻变奇缘
杀人直播	嗜血审判
杀人红包	嗜血审判
湮滅(港)	湮灭
大樂師．為愛配樂	大乐师．为爱配乐
我不是李莲英	我不是李连樱
小戏骨：长征儿女	小戏骨：我要当红军
小戏骨：长征	小戏骨：我要当红军
小戏骨：长征篇	小戏骨：我要当红军
尼德兰的微笑	见习爱神
小狗本吉	神探狗笨吉
丑恶直播	放开那个女孩
另类爱情2	另类爱情2独一无二
恐怖禁忌之回头路	午夜惊魂路
鬼魅尸语	鬼魅屍語
碧血丹心	碧血丹砂
比基尼大战之麻辣激情岛	我不是奇葩之疯狂沙滩
我不是奇葩	我不是奇葩之疯狂沙滩
我想我们现在很孤独	此刻只有你共我
此刻只有你和我	此刻只有你共我
岛（制作名）	孤岛终结
冥房(台)	幽冥之家
父子魂斗罗	父子雄兵
翻滚吧，姐妹	翻滚吧姐妹
好姐妹跳起来	翻滚吧姐妹
我的女友是丧尸	我的丧尸女友
一梦万金	童子尿万金
古堡魔咒	情迷地中海之古堡魔咒
阴阳中间站	阴阳先生之阴阳中间站
男狐聊斋-秀郎	男狐聊斋
暴走的潘金莲	暴走の潘金莲
盗盗盗，非常道	盗盗盗·非常道
请你把钱还给我	非常绑架
禁闭者	惊悚小说
菸蒂	烟蒂
爱如此醉人	爱是永恒
董永七仙女新传	恋恋仙缘
斗鼓	斗·鼓
高石寨	斗·鼓
小男人週記3之吾家有喜	小男人周记之吾家有喜
小男人周记3	小男人周记之吾家有喜
幸孕二胎	幸孕
越来越囧	越囧
只有她看得见	魂在囧途
牙颤	牙痛入心
逗比恋人	猫先生与猪小姐
阿怪与阿妖	泰逗2018
钢铁坟墓2(台)	金蝉脱壳2：冥府
移动地宫	移动心迷宫
杀戮元年(台)	人类清除计划4
国定杀戮日：屠亡前传(港)	人类清除计划4
找朋友	原来我们如此陌生
生命中的美好意外(台)	一生
生活本身	一生
人生如戏	一生
白雪公主真人版	白雪公主
帶我去月球	带我去月球
品格：新华社建社85周年	品格
胡彦祖的时空转椅	时空转椅
诡目迷情	鬼目迷情
猎艳大师	猎爱大师
北京，北京	春风十里
百吻神探	都市神探录I：长城在上
都市神探录1长城在上	都市神探录I：长城在上
疯狂的屌丝	拜见女仆大人
九五2班	九五二班
山的那一邊	山的那一边
槑计划	呆呆计划
合租惊魂	幽灵会所
灵魂摆渡大电影	灵魂摆渡·黄泉
灵魂摆渡 电影版	灵魂摆渡·黄泉
灵魂摆渡·黄泉篇	灵魂摆渡·黄泉
魔影狂花	魔女狂花
猪猪侠4	猪猪侠之英雄猪少年
2016天猫双11晚会	2016天猫双十一狂欢夜
我来也异闻录	我来也
1：处男宣言	第1次
第1次之处男宣言	第1次
禁锢之屋	骇故事之禁锢之屋
橘子老兄	橘子哥
交易	假期惊魂
末日使者·救赎	末日使者救赎
第四道封锁线	血战湘江
心潮囧动	傻哥的逆袭
我不是马金莲	傻哥的逆袭
性教獄(港)	错误教育
她的错误教育(台)	错误教育
卡梅伦的错误教育	错误教育
七扇门之嗜血将军	嗜血将军
风尚2015	SNH48首届年度风尚大赏
SNH48第二届Best30演唱会	SNH48第二届年度金曲大赏
SNH48 REQUEST TIME BEST30 演唱会	SNH48第二届年度金曲大赏
美声人质(港)	美声
美声唱法	美声
机动战犬(港)	机器猛犬
机器战犬(台)	机器猛犬
夜奔	笑着活下去
冒牌伴郎生擒姊妹团2	婚礼傲客2
婚礼终结者2	婚礼傲客2
真实的潘金莲	大明奇冤
死亡飞车4	死亡飞车4：混乱之上
位居次席	副总统
为副不仁	副总统
屌丝男女之命运赌神	命运赌神
3D蛋计划	蛋计划
十全九美2	十全九美之真爱无双
第1次之青春雄起	第1次2：青春雄起
3：最后决战	第1次
第1次之最后决战	第1次
大卫贝肯之倒霉特工熊3D	大卫贝肯之倒霉特工熊
爱在生死间	让爱活下去
超级东北人2	御宠娇妃
欲宠娇妃	御宠娇妃
网络太虚伪	网络与现实
电竞高校Ⅱ	电竞高校2
第36屆香港電影金像獎頒獎典禮	第36届香港电影金像奖颁奖典礼
北大差生	我的青春都是你
三好差生	我的青春都是你
囚禁少女之恐怖直播	囚禁少女
凶宅灵异事件	惊魂七夜
疯狂女校之窈窕男友	女校也疯狂
导演梦	电影之狂
尸体	汉娜格蕾丝的着魔
同窗四年之我们的成人礼	我们的成人礼
低壓槽	低压槽：欲望之城
低压槽	低压槽：欲望之城
凶宅	骇故事之凶宅
深爱榜	深圳爱上你
别急，他不会走很远的	别担心，他不会走远的
别急，他的脚走不了	别担心，他不会走远的
笑画人生(台)	别担心，他不会走远的
近人勿念	别担心，他不会走远的
赌博默示录中国版	动物世界
绝命酒店(港)	阿尔忒弥斯酒店
计中计	打眼之计中计
打眼之第一罐金	第一罐金
八個女人一台戲	八个女人一台戏
8個女人1台戲	八个女人一台戏
塞纳河一选	“一心向前”SNH48第一届偶像年度人气总选举演唱会
你好	再见
紅衣小女孩2	红衣小女孩2
恐怖殡仪馆	骇故事之恐怖殡仪馆
殡馆异闻录之虫	骇故事之恐怖殡仪馆
亲风	税风亲清
一路奔放	一路风骚
吻瘾者	吻隐者
逃兵	奔跑吧
我不是逃兵	奔跑吧
迷失姑苏	我相信
鲤鱼Ⅱ	江湖水
秀犬	汪星卧底
犬展	汪星卧底
萌犬卧底	汪星卧底
汪牌特工	汪星卧底
出Show狗仔隊(港)	汪星卧底
安杜佛	安多弗
以上	安多弗
SNH48 REQUEST TIME BEST50 演唱会	SNH48第三届年度金曲大赏
老萧帮帮忙	老肖帮帮忙
佛学的母亲	机器人妈妈
机器人母亲	机器人妈妈
強尼·凱克	强尼凯克
强尼·凯克	强尼凯克
午餐女巫	魔法厨娘
动物凶猛	高级动物的爱恋
打破与退出	闯入逃离
小镇惊魂	杀人魔画
冥画	杀人魔画
神探少女M之电视台疑案	神探少女M
千年追凶	梦迷镇
小戏骨之包青天	小戏骨：包青天之秦香莲与陈世美
大②神捕	大二神捕
大二神捕1	大二神捕
1314室	13·14室
《天降惊喜》	饭醉团伙
往生刑	骇故事之往生刑
原创·梦想	原创梦想
紫桐花开	一树一树紫花开
王牌御史	王牌御史猎妖教室
九州·黑暗之子电影	九州·黑暗之子
揭幕战	初赛
會飲Club	会饮俱乐部
女明星血泪史	女明星奋斗史
两朝皇后	后宫风韵传之霓裳玉女
漂流心海(港)	惊涛飓浪
我愿意(台)	惊涛飓浪
漂流	惊涛飓浪
命悬一线	索命空间
叶问山	冒牌宗师
Great Form Has No Shape(英)	大象无形
前桌后座	校花来了之前桌后座
与艾米丽共度的狂野之夜	与艾米丽的疯狂夜晚
女舍惊魂	骇故事之女舍惊魂
二环以里	醉+拍档
错爱今生	错爱，爱错
身后有鬼	嘘，小心身后有鬼
姐姐好饿剧场版之花样厨神	姐姐好饿剧场版之御厨大作战
浙江卫视2017跨年演唱会	浙江卫视“爱在一起”2017演唱会
灵异山谷	死亡谷
刺客国度	暗杀国度
坏妈妈2	坏妈妈的圣诞节
C奶同学会2(港)	坏妈妈的圣诞节
阿姐响叮当(台)	坏妈妈的圣诞节
麻辣厂长	热血教师之麻辣厂长
深圳卫视跨年演讲2016	深圳卫视“时间的朋友”2016跨年演讲
时间的朋友2016	深圳卫视“时间的朋友”2016跨年演讲
触爱可及	圆梦金秋
小脚怪(台)	雪怪大冒险
寻找小脚八(港)	雪怪大冒险
小脚	雪怪大冒险
雪人寻人记	雪怪大冒险
大脚怪奇遇记	雪怪大冒险
小脚丫与大脚怪	雪怪大冒险
年轻的选择-2016优酷盛典	年轻的选择
烟	夜的诗人
绑架女主播	终极囚禁
美人首	聊斋志异之美人首
无罪日	骇故事之无罪日
归期未有	黑白之山
牛鬼蛇神弟控神经女保姆活生声回忆录	家蛇
饭局女郎II	饭桌女郎
舞动梦想	一诺.千金
枭将级	新西兰探案之枭将级
不完美的意外	两个人的法式晚餐
上影版四大名捕	四大名捕之入梦妖灵
王权富贵 总集篇	狐妖小红娘剧场版：王权富贵
极恶江湖-古惑镇传奇	极恶江湖之古惑镇传奇
岭城兄弟之硬茬儿	岭城兄弟情
女尊三国	女尊·三国志
山中木屋	缺失的爱
追哥哥张国荣迷	追忆哥哥张国荣
异人列传之魔游纪	魔游纪1：盘古之心
魔游纪	魔游纪1：盘古之心
原点	起源
高污禁欲系少女	高禁系少女
游戏夜杀必死(台)	游戏之夜
今晚玩救你(港)	游戏之夜
黑水	深海越狱
玩大啦	垫底联盟
梦春记之古墓迷情	梦春记
换心	梦春记
死神春风	梦春记
撩妹时光机	梦春记
重庆之恋	骑摩托的青蛙
边境杀手	血战边境线
紅樓夢	红楼梦
同志版红楼梦	红楼梦
宝贝不哭之麦豆的夏天	麦豆的夏天
比基尼2-银河少女	银河少女
小戏骨：三国演义	小戏骨：放开那三国
小戏骨之三国演义	小戏骨：放开那三国
小戏骨：三国篇	小戏骨：放开那三国
老少咸宜之完美攻略	完美攻略
坑蒙拐骗偷	疯狂的彩票
缝隙世界	所罗的梦境之门
巴斯特民谣	巴斯特·斯克鲁格斯的歌谣
巴斯特的歌谣	巴斯特·斯克鲁格斯的歌谣
西部老巴的故事(台)	巴斯特·斯克鲁格斯的歌谣
细说当年话西部(港)	巴斯特·斯克鲁格斯的歌谣
魔咒之辣妹男神	魔咒
咏春侠奇遇超级女神	咏春侠
好极了	大世界
罗本的反击	老司机
灵瞳	异闻录之灵瞳
吃不了兜着走之港城风云	港城风云
陌上花开可缓缓归矣	陌上花开
网红主播之惊魂夜诱	网红魅影
诡案组Ⅱ	诡案组之骷髅碟仙
烈日军火库	僵尸军火库
情书	小情书
安娜与末世	安娜和世界末日
死亡来电	恐怖游戏之死亡来电
日月星辰	老兽
老混蛋	老兽
小哈皮	离散的范畴
津门八卦掌	百家拳之津门八卦掌
奇异兄弟	怪才兄弟
Hello 白小姐	我的蛇精女友
萬水千山縱橫	逆流大叔
赤裸青春	折翼的候鸟
男孩爱最大(台)	星期六的教堂
灵魂摆渡3 剧场版	灵魂摆渡之风华绝代
灵魂摆渡3 SP	灵魂摆渡之风华绝代
智能天使250	智能天使
留住醉后一首歌(台)	布雷兹
出走(台)	痼习之地
变节记(港)	痼习之地
聖女奇緣	女人永远是对的
缘分天注定	女人永远是对的
圣女奇缘之槟城恋战	女人永远是对的
阴阳路之常在你左右	常在你左右
探秘历史	国宝档案特别篇
恶人之无人过境	无人过境
大话天竺	西游记之真假公主
你完蛋了，老铁	游戏结束，老兄！
老兄GG啦(台)	游戏结束，老兄！
老友Game Over喇(港)	游戏结束，老兄！
銅板少年	铜板少年
@春晚2016	2016@春晚
小丑的愤怒	槟榔血
妖妖铃	妖铃铃
妖妖零	妖铃铃
玲姐大闹萌贵坊	妖铃铃
铃姐大闹萌贵坊	妖铃铃
风送滕王阁	滕王高阁临江渚
凡尘山门	山门
禁视	我的二重身
唔黐线唔正常	唔痴线唔正常
黄子华栋笃笑唔黐线唔正常	唔痴线唔正常
欢笑中国 2017年东方卫视鸡年春节联欢晚会	春满东方
2017东方卫视春晚	春满东方
飞火流星	遇见你真好
亲爱的冤家	我是你妈
以青春的名義	以青春的名义
以青春的名义爱你	以青春的名义
最後的詩句	最后的诗句
濁流	浊流
公视人生剧展「无敌战舰协和号」	无敌战舰协和号
乳房	乳。房
赛尔号6圣者无敌	赛尔号大电影6：圣者无敌
赛尔号大电影6	赛尔号大电影6：圣者无敌
八步半喜怒哀樂	八步半喜怒哀乐
麥呆的劈腿日記	麦呆的劈腿日记
结婚那点事之后	为爱担当
星际炮兵团;护花使者	星际炮兵团之护花使者
大君主之役(港)	霸主
霸王行动	霸主
君主	霸主
大君主行动	霸主
虚拟情人Ⅱ	虚拟情人2
初戀日記：賤男蜜擾	初恋日记
初恋日记：贱男蜜扰	初恋日记
金钱与爱情	江湖儿女
灰烬是最洁白的	江湖儿女
放浪记	心火2017
子归	婴灵奇谭
醒醒吧1	醒醒吧之大师
醒醒吧，XX	醒醒吧之大师
醒醒吧xx	醒醒吧之大师
青少年精神	少年追梦情
王皓去哪儿了？	一路癫狂
草原往事之弓马啸西风	弓马啸西风
醒醒吧2	醒醒吧之道德骑士
醒醒吧3	醒醒吧之跟风者
风雨江湖	狂隐剑
雄霸古惑仔之龙出江湖	龙出江湖
深圳故事之无关风月	深爱十年
3D电影昆曲《景阳钟》	景阳钟
西厢记3D	西厢记
3D电影越剧《西厢记》	西厢记
江湖风云之麻将街娃	麻将街娃
心理警示录之双面人	心理警示录之看见恶魔
无痕成长	不留痕迹
叶落无痕	不留痕迹
湖南卫视2009成人礼盛典	2009成人礼盛典
死亡营救之哥哥篇	哥哥
无人返还	无人返还之远洋大逃杀
远洋大逃杀之无人返还	无人返还之远洋大逃杀
成都恐怖故事之尸解游戏	杀戮游戏
尸解游戏	杀戮游戏
蛋囧	雏盗
三重门电影版	青春演绎
女法医手记(下)	女法医手记之最后真相
心理警示录 大赌徒	心理警示录之大赌徒
美人清除计划	圈养女主播计划
末世国货	末世家园
时间猎杀者	时间·猎杀者
中国天问	神州天问
天师之九转轮回盘 第一部下	天师之九转轮回盘（下）
大唐秘史之大唐快递侠	大唐快递侠
《大逃杀2017》	循环绑架
五十八座半	五十八座·半
五十八座半	五十八座·半
鹦哥岭，最后一枪	鹦哥岭之盗猎禁区
报仇	报复
男狐聊斋2	男狐聊斋2兰若寺
不一样的美丽锦州	美丽锦州
自古蓝白出CP	拜托！别黑我！番外
漆黑的走廊尽头	邪恶宿舍夜惊魂
黑暗走廊惊魂	邪恶宿舍夜惊魂
沉入暗黑走廊	邪恶宿舍夜惊魂
一个杰克这样的孩子	孩童杰克
西游之天蓬元帅	西游记之天蓬元帅
不分手大师	脱轨男女
无人入睡	七星期
大富翁	一出好戏
诳想曲	一出好戏
猜猜我是谁	巨额来电
反诈风暴	巨额来电
第七届金鹰电视艺术节颁奖典礼	第24届中国电视金鹰奖颁奖典礼
岗山姐妹恋	岗山恋
想恋爱	岗山恋
非孕私生活(台)	私人生活
不育私生活(港)	私人生活
七把枪	7把枪
whisper偷偷跟你說	偷偷跟你說
梦想心乐章(台)	超乎想象
想更认识你(港)	超乎想象
小兔子有颗玻璃心电影版	愤怒的兔子
选美计之双生天娇	选美计：双生天娇
如影随形	她在身后
若兰	她在身后
七娃抓妖记	七娃捉妖记
血路	血战漫川关
康胡黄白之鸡飞狗跳	鸡飞狗跳
皇家酒店的悲惨时光	皇家酒店谋杀案
坏事大饭店(台)	皇家酒店谋杀案
贼眉贼眼大酒店(港)	皇家酒店谋杀案
血，沙子和黄金	金沙血
角頭2：王者再起	角头2：王者再起
跑吧！兄弟	家政侦探社
谁也别想睡觉	能动手别吵吵
灵界基友2	灵界基友2床仙
灵界室友2	灵界基友2床仙
床仙	灵界基友2床仙
老人与狗	忠爱无言
老人和狗	忠爱无言
殺出龍門客棧	杀出龙门客栈
幽浮檔案(台)	幽浮档案
佈局者	布局者
書劍	书剑
鬼網	鬼网
山村古宅	古宅
我的情敵女婿	重新爱你
百星贺囍2018	重新爱你
我的情敌女婿	重新爱你
新僵屍先生2	新僵尸先生2
红月亮花灯	红月亮之武陵山歌
L風暴	反贪风暴3
私人會所	私人会所
霸道爱情	霸道爱情之恋上灰姑娘
原罪	大嫂
全力的游戏	荒山心野之七日
CCTV10文史探秘：畅享水边美味	畅享水边美味
小戏骨：降妖记	小戏骨降妖记
花木兰前传	花木兰传奇
花木兰传说	花木兰传奇
入梦师	入梦师：觉醒
无声绝境(港)	寂静之地
噤界(台)	寂静之地
静地	寂静之地
死神游戏：TRUTH OR DARE(港)	真心话大冒险
被遗忘的幸福(台)	他们有什么
行动代号：特工EX(港)	我的间谍前男友
老娘也要当间谍(台)	我的间谍前男友
抛弃了我的间谍	我的间谍前男友
衰兄囧弟	岛国狂想曲
时间浪人之爱你一大跳	时间浪人
合伙人	奔跑吧
警告射击	鸣枪警告
示警	鸣枪警告
赌神2017	废柴赌神
摇滚老爸	摇滚吧！老爸
江海渔童	江海渔童之巨龟奇缘
牧師的秘密行動(台)	牧师
我爱我家电影版	我爱我家
天师救僵	生化药尸
万有坏坏力	九里达
世外桃源	黑白照相馆
末法时代	驱魔天团
黑警	嗜好
床3之他和她的关系	熟悉的陌生人
床3	熟悉的陌生人
床上关系3	熟悉的陌生人
勘玉钏(京剧)	勘玉钏
我和爷爷	屋顶上的猫
超能宅男	魔法王座之超能宅男
特有种部队	合金战队
魔游记	魔游纪3：天都暗潮
老屋(港)	老房子
老宅(台)	老房子
老房(日)	老房子
六月雷声有点大	漂浮
魔游记	魔游纪4：白骨之姬
魔游记	魔游纪5：宿命之争
魔游记	魔游纪6：一瞬决战
《失恋33天》群像	失恋侯群症
雪镜男神	嘶吼青春之我的雪镜男神
毒辣	忍无可忍
骄傲玛丽	骄傲的玛丽
终结行动	最终行动
终极行动	最终行动
功夫大联盟	功夫联盟
53号白公馆	53号白公馆之双生姐魅花
天使怎么了(台)	天使降临
极速杀手	极速杀机
古惑仔之社团风暴	江湖之社团风暴
一路前行3(台)	佐州自救兄弟3
杀无赦I	杀无赦I入局
杀无赦1	杀无赦I入局
瀏陽河	浏阳河
我的危险妻子中国电影版	我的危险妻子
贴背战(台)	抓人游戏
标签	抓人游戏
甜心主播	甜心主播大作战
ひょうたん奇譚の六ドールの秘密 （日）	葫芦奇谭之六娃的秘密
Hi，大妞	虎色虎香
聊斋之玄夜狐影	玄夜狐影
梦境夺命	控梦师
特种人类	异能者2
我想要你记得	我想要你记得＿
爱之墙	我想要你记得＿
菊花岛漂流记	米花岛漂流记
让我把话说完	长谈
长谈：让我把话说完	长谈
钟馗外传	钟馗传奇之岁寒三友
成都僵尸	成都异闻录之僵尸直播
明镜火拍	测试求通过，之后自己删
明镜火拍	测试求通过，之后自己删
扬州八怪之风云乱扬州	风云乱扬州
扬州八怪之乾隆痛失郑板桥	乾隆痛失郑板桥
扬州八怪之情断莲花庵	情断莲花庵
将界十日诀	将界十日决
将界·十日决	将界十日决
玫瑰玫瑰我愛你	玫瑰玫瑰我爱你
李宗瑞	有罪
歌手2017巅峰会	歌手：十全十美巅峰会
天路将军慕生忠	天慕
携创第一部微电影	守护天使
资江双侠大破地狱门	资江双侠
重返1997	重返一九九七
谈梦九七	重返一九九七
御宅笔记	闺蜜的正确打开方式
天安社之义字当先	兄弟之义字当头
三只小猪与功夫潘达	三只小猪2
姐就是美(台)	超大号美人
美丽爱自信	超大号美人
自觉美丽	超大号美人
人家美着呢(豆友译名)	超大号美人
三只小猪3	三只小猪与四十大盗
業子	业子
浅喜深爱	住在隔壁的女孩
我们曾经年轻过之味道	原味校花恋上我
梦想公园	超级疯狂
废话少说	陈翔六点半之废话少说
2011年环球小姐华彬大赛	2011环球小姐中国区总决赛
割喉蚊2：尸蚊	阴间蚊子2：爬出乱坟岗
过河入林	彼岸林海
杀手李昂	杀手如花
冥中注定我愛你	冥中注定我爱你
不死男友是血族	爱上吸血鬼
杀人游戏夺命骷髅	杀人游戏之夺命骷髅
007之杀人游戏夺命骷髅	杀人游戏之夺命骷髅
罗拉快跑中国版	罗拉快跑
华氏451度	华氏451
释青春之青春梦	释青春2
听说马伟今天来	女人是男人的未来
弑神之英雄崛起	弑神之英雄觉醒
清醒梦	清醒梦之马桶睡美人
15:17 巴黎列车(台)	15点17分，启程巴黎
15时17分，启程巴黎	15点17分，启程巴黎
15:17开往巴黎	15点17分，启程巴黎
15点17分到巴黎	15点17分，启程巴黎
列车危情	15点17分，启程巴黎
巴黎列车剿恐记	15点17分，启程巴黎
王撕葱相亲记	相亲风云录
特殊使命	拯救计划
VR隐秘爱人	隐秘爱人
一天一夜	一天零一夜
漫长愚蠢之路	漫长的沉默之路
京剧猫大电影	京剧猫
大喜当头(台)	疯狂婚礼周
那一周	疯狂婚礼周
李白的耳朵	盗听者
第7秒	第7秒营救
百家碎戏 无言的爱	无言的爱
星厨驾到 第四季	鲜厨当道
神厨归来之驴肉火烧	驴肉火烧
大多头：天空才是尽头	大多头之股民的名义
秘爱	恶魔总裁的契约情人
归路	赎字街头
超级北京人	少女擒兽记
青春日记	麻辣学院
宝岛青春日记	麻辣学院
超级代课老师	麻辣学院
上帝保佑坎坷的旅途	上帝保佑破碎的道路
少年包青天Q版动画	少年包青天
和平西桥	和平里之夜
三個綁匪七條心	三个绑匪七条心
3個綁匪7條心	三个绑匪七条心
海人魚	海人鱼
海。人。魚	海人鱼
薄荷殺姬(港)	薄荷
血薄荷(台)	薄荷
薄荷杀手	薄荷
读书俱乐部	读书会
高年级姐妹会(台)	读书会
Bloody fight the Island，血战打渔岛	爱国岛
不死鸟	消失的妻子
笼中嬲	奇葩三人行
仙医神厨3上海任务	仙医神厨3
宝贝	宝贝儿
青春年华	那些年
陇东刀客之悍匪围城	悍匪围城
陇东刀客之智谋销烟	智谋销烟
陇东刀客之浴血护镖	浴血护镖
杀人启事	画师
2次初恋	二次初恋
遇见另一个你	一分二
超感八人组	超感猎杀：完结特别篇
超感8人组	超感猎杀：完结特别篇
211紧急呼救(台)	代码211
代码二一一	代码211
二一一	代码211
第二季	中国功夫史
第三季	中国功夫史
人人有功练	中国功夫史
完全邪恶指南(台)	极恶之地
OFFRANGE 橘子	亚男亚女睡前故事
失踪节选A	失踪节选
窒息的河流	窒息河流
皮囊	皮肤
你是我兄弟3	你是我兄弟巅峰决战
~風来坊シリーズ~	野花
曼森家族	查理说
爱慕之旅	胡杨的夏天
割喉蚊3：猛兽的蚊子	阴间蚊子3：等待猎物
爱慕	情人
如何拯救	拯救·欲望都市
御前厨神-满汉全席	御前厨神
结婚前夜	直到世界的尽头
第54屆金馬獎頒獎典禮	第54届金马奖颁奖典礼
第54届台湾电影金马奖	第54届金马奖颁奖典礼
再见奥特曼	钢铁飞龙之再见奥特曼
钢铁飞龙大电影	钢铁飞龙之再见奥特曼
秋野·春潮	秋野春潮
误会啦爸爸	误会啦
妈妈咪呀！2	妈妈咪呀2
妈妈咪呀！回来了(台)	妈妈咪呀2
妈妈咪呀！开心再嚟(港)	妈妈咪呀2
妈妈咪呀2：再次出发	妈妈咪呀2
妈妈咪呀：重蹈覆辙	妈妈咪呀2
梵高.永恒之门(港)	永恒之门
梵谷：在永恒之门(台)	永恒之门
在永恒的门口	永恒之门
在永生之门	永恒之门
偽婚男女	伪婚男女
还是一家人	伪婚男女
绝色行动之克隆特攻	克隆特工之极限对决
黑客法则：变色龙军团	黑客风云
另一个她	在剧场
马达的情书	情书
白发红皮书	情书
蓝翔传奇-蓝领之王	蓝翔传奇
耍宝太君2：占山为王	耍宝太君2
遗城-鹰眼猎人	遗城
喵酱大人	猫妖传奇
豪门少爷的宠物情人	猫妖传奇
台北物語	台北物语
愤怒的鸭子	妙先生之愤怒的鸭子
笔仙VS伽椰子	笔仙咒怨
霾后余生之末日狂花	血姬传
情迷直播室	宅男爱上她
呼啸青春	那一场呼啸而过的青春
那一场呼啸而过的青春电影版	那一场呼啸而过的青春
支援女孩	支持女孩们
镜相人	镜像人·明日青春
幼稚園老師(港)	幼儿园教师
妈妈和宗宪(台)	妈妈和宗宪
幻乐一场	王菲：幻乐一场
大公司之疯狂的豆子	疯狂的豆子
大话西游前传	悟空前传
风华昭雪美人图	美人图
赶尸惊魂2	邪王重生
天池夕阳下	温暖如故的日子
绿簿旅友(港)	绿皮书
绿书	绿皮书
草木惊心	惊弓之鸟
主播学院	主播军团2：主播学院
主播社团	主播军团3：主播社团
極闘4暴殺令	极斗4之暴杀令
纯爱游戏	女神解码器
無聊電影	无聊电影
西安城外	长安外
拯救明天	时间牢笼
葛洛利亚	葛洛利亚·贝尔
尸人保姆2	妈妈2
紫色纽约(台)	紫色纽约
娜娜的一天	娜娜
姚子青	捍卫者
幸福谷	帕特诺
追钱逗爱熊仁镇	欢迎来到熊仁镇
超时空女神	一路狂花
终极任务	忏悔
恐怖创世神	死亡事3：电梯
爱的过去进行式(台)	致所有我曾爱过的男孩
結婚禁行曲	结婚禁行曲
我永远的女孩(台)	永远是我的女孩
时弦  第一章：末世起点	时弦
爱情缘规律之咏春女孩	咏春女孩
猎兽少女	猎兽少女队
小娘们	小女人
抹去的男孩	被抹去的男孩
狂屠绝路(港)	曼蒂
曼迪	曼蒂
不二女警之网红计划	功夫宅男之绝版女神
之墓野迷踪	诡宅丽影
诡宅丽影之墓野迷踪	诡宅丽影
逃不出的诡宅	诡宅丽影
风	风在追
烦恼	风在追
青春热之恶魔软妹帮	恶魔软妹帮
杜蕾斯的爱情生活	杜蕾的爱情生活
大象林旺	大象林旺之一炮成名
东白湖	嗨
不能唤醒的爱	三生三界情人劫
° 有意话续集》	《人形物
《人形物24小时全记录》	《人形物
王伯祥	王博祥
父亲2017	父亲
黄金七十二小时	黄金兄弟
新古惑仔	黄金兄弟
新版古惑仔	黄金兄弟
江湖	大侠
每，一天(台)	每一天
逆天侠盗团2千面贼王	逆天侠盗团2：千面贼王
下課前一分鐘	下课前一分钟
《觅谜》	觅谜
最后的告白三部曲	最后的告白
初吻中国版	初吻
扮工室上位攻略(港)	抱歉打扰
起底組	起底组
老陳和小鬼	老陈和小鬼
马纳小镇市集的鬼	老陈和小鬼
燃青春之旋风辣妹	旋风辣妹
西域列王纪电影版	西域列王纪
云水之旅	云水
控烟英雄	未了的心愿
简单帮个忙	一个小忙
举手之劳	一个小忙
失踪网红(台)	一个小忙
小心帮忙(港)	一个小忙
我是猎妖师 第二部	我是猎妖师2
包夜	包宿
香君诀	片甲不留
名将	片甲不留
极品屌丝	我的神秘女友
突出部之役	仙境
裂缝	空间裂缝
凸槌特派员3(台)	憨豆特工3
特务戆J：神级归位(港)	憨豆特工3
憨豆特工再出击	憨豆特工3
伊丽莎白收获	收割伊丽莎白
火的考验	凭火决狱
搖滾樂殺人事件	摇滚乐杀人事件
刺激人生：乘風	刺激人生：乘风
刺激人生：追風	浅爱
刺激人生：逆風	刺激人生：逆风
刺客后传系列之鱼肠剑	鱼肠剑
街頭祖霸王(港)	德鲁大叔
心·迹 敦煌	行走的力量
辽大毕业纪念电影	钟
隆尧浪漫的人	魅力隆尧浪漫的人
我的同事桔梗先生	流逝
我的雪镜男神	我的魔镜男友
杀不死	特攻杀阵
小寡妇成仙记	北方一片苍茫
鱼龙勇士2之深海捕鱼大赛	鱼龙勇士2
民国灵异录	新聊斋之僵尸新娘
滚蛋回家	下半城风云
回归1997	归来1997
我是坏人2017	我是坏人
明星计划	迷魅北京
青春热之超隐形男友	超隐形男友
馬里博爾起義現場：這是一部互動式電影	马里博尔起义现场：这是一部互动式电影
与君相恋100次中国版	与君相恋100次
小燕子和他	山无棱天地合
我的同桌是极品2变身无敌	我的同桌是极品2
胡子小姐与裙子先生	来一达麻花
醉佳导演	“醉”佳导演
老师别闹	“醉”佳导演
平妖之如意天书	平妖传
猎灵技师	灵犀效应
死循环	逃不出的情人节
二流太傅之赤霄剑	二流太傅
旋风少女电影版	旋风少女
灵魂当铺	灵魂当铺之时间典当
巡楼人	巡楼人之舞灵
舞灵	巡楼人之舞灵
假如比尔街能说话	假若比尔街能够讲话
鸟包大行动(台)	我的宝贝在哪里
玩意儿	我的宝贝在哪里
为奴隶的母亲	典妻
第一季	王者历史课
愛情奴隷獸	爱情奴隶兽
我们的6E班	6E班
红衣	红衣诡村之幻·谜
侧耳倾听	侧耳倾听3
大奖	乌龙大奖之亡命穷途
如父	虎父无犬女
桃出天际	天上人间
物去	上了
僵尸族崛起	僵尸族的崛起
家在蘭若寺	家在兰若寺
奪命追兇	夺命追凶
三年高考	五年模拟
无名镇杀人录—刺狐	刺狐
幼兒怨	幼儿怨
好鬼两个半II之鬼王争霸	好鬼两个半2鬼王争霸
怦然心动的节拍(台)	心跳砰砰响
疯人院(台)	失心病狂
疯·魔(港)	失心病狂
荒诞	失心病狂
表演者	失心病狂
鸟箱	蒙上你的眼
藍色項圈	蓝色项圈
顺德人家	顺德人家之合家欢
天师救僵	生化药尸
罪途1	罪途1之死亡列车
罪途I之死亡列车	罪途1之死亡列车
罪途之死亡列车	罪途1之死亡列车
找寻	追
最美的風景	最美的风景
异能情人	预言家请睁眼
自杀小队：惨痛代价	自杀小队：严厉惩罚
宵闇真珠	白色女孩
二龙湖浩哥之乱世豪情	乱世豪情
箫魂传之上古神器	箫魂传2上古神器
千颜总集篇 我只要你能获得幸福	狐妖小红娘剧场版：千颜
我的禮物	我的礼物
GROUP第四届偶像年度人气总决选演唱会	“我心翱翔”SNH48
悲伤逆流成河电影版	悲伤逆流成河
隐隐惊马槽	隐隐惊马槽之决战女僵尸
逆生	逆生·致亲爱的小孩
逆生：致亲爱的小孩	逆生·致亲爱的小孩
高人之花之语	高人
彬彬教授-许我爱你	许我爱你
黑白世界的音符	过往的梦
玩謝大師	玩谢大师
玩谢大作家	玩谢大师
灵狐圣子1	灵狐圣子1：圣子出世
圣士提反	某日某月
日月星	某日某月
天降横财之鬼算子	鬼算子
衰兄囧弟	岛国狂想曲
盜命師	盗命师
時光	时光
阿科桑蒂	亚高山地
羅馬尼亞來的人	罗马尼亚来的人
摧毁者	无间炼狱
17岁半	了不起的高二八班
十七岁半	了不起的高二八班
慌枪走板	无名之辈
聖荷西謀殺案	圣荷西谋杀案
桂湖之夏	毕业初体验
被嫌弃的我之桂湖交响乐	毕业初体验
恐怖创世神2：梦眼	死亡事
月黑风高潮	月黑风高夜
血觀音	血观音
修罗花	血观音
洞窥媚香	深宅谜影
深宅迷影	深宅谜影
灵狐圣子2	灵狐圣子2：仙山大战
功夫机器侠·北腿	功夫机器侠之北腿
满地黄花	我的警察爸爸
天下足球托蒂退役专辑	狼图腾：一人一生一座城
鸡毛系列	鸡毛梦想
以为是老大之金三角风云	以为是老大II金三角风云
以为是老大2金三角风云	以为是老大II金三角风云
誰先愛上他的	谁先爱上他的
套路之王	美人套
超级河南人	美人套
追梦骑士	骑遇
智齒	智齿
那些年的我们	瞬爱
Instant Love（英）	瞬爱
时空三部曲第一部：时空送货人	时空送货人
荒野之花	风回路转
旅游结婚	终点的婚礼
婚礼冤家(台)	终点的婚礼
錯位	错位
不老心房之陆老慧心	不老心房
师徒乐之二擦汽车	擦汽车
揣梦红楼梦	红楼梦之萌娃演绎大观园
刘姥姥进大观园	红楼梦之萌娃演绎大观园
红楼梦之最萌刘姥姥	红楼梦之萌娃演绎大观园
让世界看见你	这一刻，我要世界看见
你是我兄弟2	你是我兄弟之牌王
人	漂泊的人
白日梦	白日做梦
口袋宇宙	超时空同居
粉丝答谢演唱会	快乐男声2017
齐天大圣万妖之城	齐天大圣·万妖之城
辣警霸王花2不义之战	辣警霸王花2
時光理髮	时光理发
春天读诗之夜：我们的心又合法健康地淫荡起来了	春天读诗之夜
2017春天读诗之夜：远方诗人的来信	春天读诗之夜2017
鸭酱	鸭油
暗魇迷宫(台)	暗魇迷宫
墨色丁香	墨色·青春
黑暗中的星光	你给的仇恨
你的敌意	你给的仇恨
谜踪	找到你
爱在选举夜	洛城一夜
6年，6天	六年，六天
最后一次在爱达荷	谋杀预想
猛虎嗅蔷薇之舞盗团	猛虎嗅蔷薇之舞“盗”团
建国大案之一级戒备	反特大案之一级戒备
建国第一大案之一级戒备	反特大案之一级戒备
西河口秘闻	西河口秘闻之无头新娘
我的青春岁月	我们的青春岁月
藏地密码电影版	藏地密码
數到十，讓我變成沈曉旭	数到十，让我变成沈晓旭
赢在昨天	庄家
- 頭文字B	頭文字D外傳
与狗狗一起生活	狗狗之日
即时家庭	速成家庭
京城怪谈之水箱迷案	京城怪谈之水箱谜案
震荡	京城怪谈之水箱谜案
造梦机器	造梦大师
房事	房子与狗
生死劫难	囚禁空姐
浮世经验	北国之春
看見你便想念你	看见你便想念你
末栈第一部	末栈之怪笔新娘
秦时明月之端木蓉特别篇	秦时明月之医者入世
狼人杀之电台风波	狼人杀
电影少年悍将GO！(台)	少年泰坦出击电影版
老木匠-郁庭茂	老木匠
婚姻多少钱一斤	疯狂的彩礼
鬼狐传说·聂小倩	倩狐传
重返人间72天	72天搞定你
金羊毛	大象席地而坐
爱在樱花盛开时	大象席地而坐
血拳	爆裂拳师
茶缸里的女孩	养诡
西游记后传电影版	西游记后传
西游记之斗战胜佛	西游记后传
大山里的曙光	山的那一边
侦探.豆腐貂蝉	豆腐貂蝉
衝組	冲组
JU部入侵计划	局部入侵计划
第37屆香港電影金像獎頒獎典禮	第37届香港电影金像奖颁奖典礼
机器情人2之野蛮女管家	机器情人之野蛮女管家
熊出没5	熊出没·变形记
熊出没大电影5	熊出没·变形记
花甲大人轉男孩	花甲大人转男孩
花甲男孩转大人 电影版	花甲大人转男孩
喜迎党的十九大胜利召开特别节目	壮丽航程
十四个摄像头	监控惊魂
班恩回家(台)	本，回来了
本回来了	本，回来了
恐怖创世神3：小丑梦魇	死亡事2：小丑
时代狂人	人间·喜剧
初生牛犊	丛林历险记
吴山居事件账之蚌人	沙海番外之蚌人
黄飞鸿之王者归来	王者归来黄飞鸿
福建海洋人文三部曲之《回潮》	回潮
戏瘾症	戏隐江湖
蓝理将军	海之战
保罗，基督使徒	使徒保罗
末路爱侣	末日
为何结束	末日
末路	末日
0722：极右挪威(台)	挪威7·22爆炸枪击案
7月22日：当挪威不再挪威(港)	挪威7·22爆炸枪击案
7月22日：挪威爆炸枪击案	挪威7·22爆炸枪击案
7月22日	挪威7·22爆炸枪击案
冒牌监护人	冒牌监护人之寻宝闹翻天
我是神	恐怖创世神：起初
九號战船	深海巨妖
PG戀愛指引	恋爱之瘾
PG恋爱指引	恋爱之瘾
粤剧柳毅奇缘	柳毅奇缘
柳毅传书	柳毅奇缘
樂獄	乐狱
樂獄男孩	乐狱
恐怖邻居	帅哥要提防
邻里噩梦	帅哥要提防
毒蛇女杀手	蛇女杀手
王蛇杀手	蛇女杀手
割喉蚊	阴间蚊子
分隔线	过春天
佩佩	过春天
红缎	血缎惊瞳
神仙也疯狂	卷帘君下凡那些羞羞事儿
2017天猫双11晚会	2017天猫双十一狂欢夜
房门未关	敞开的房子
罪人与圣人：复仇	罪人与圣人2：清算日
我和叛徒老爸	我和“叛徒”老爸
一去不再来	伊犁河
江城迷案	江城谜案
蝶影之惊魂	蝶影惊魂
将军在上番外篇第二部	将军在上之时空恋人
将军在上番外篇第一部	将军在上之极乐净土
洩密者們	泄密者
泄密者们	泄密者
入鐵籠	入铁笼
将军在上番外篇第二部	将军在上之芙蓉密案
割喉蚊第四代：终章	阴间蚊子4：最终完结篇
高三那年	高三档案之消失的学姐
余罪番外之致命线索	致命线索
大東門龍虎	大东门龙虎
黄花梁上的灰猴们	灰猴
新世代小英雄(台	未来机器城
港)	未来机器城
次世代伙伴(新)	未来机器城
暴走吧！失忆超人	未来机器城
大師兄	大师兄
我的老师是拳霸	大师兄
帝皇酒店	帝国酒店
非洲遇见香奈儿	非洲遇见你
那一片栀子花	十爱
战境	战境：火线突围
不骗你骗谁	不欺不遇
鬥魚	斗鱼
斗鱼电影版	斗鱼
101次相亲	恋爱合约
冼夫人·浩气英风	冼夫人之浩气英风
玩命追击	玩命
不作不会死	四奇士和美女们
最后的锦衣卫-鸡缸杯	最后的锦衣卫
康巴之心	剑拔藏地
皇粮	粮道
人工智能之神经元	觉醒：仿生浩劫
西游之天蓬归来	天蓬归来
白日漫游	漫游
时间遗墓	时间遗墓1：九龙解棺
蝶影系列	蝶影之灾
易家相法	天瞳眼
童年周恩来	薪火相传
雪葬	雪·葬
舞可能	舞动青春之女子天团
鬼探风云	诡探风云
地球最后一个硬汉	末日硬汉
滑板少女	滑板厨房
紅塵梵谷	红尘梵高
进击的盖仑	最强王者
北海食神之面摊拯救计划	北海食神
偷换人生	嫌疑者说
死亡迷宫之时空裂缝	死亡迷宫2
救援之路	猎刃归途
猎刃雇佣兵	猎刃归途
杨家将七郎八虎之杨五郎血战青盐镇	杨五郎血战青盐镇
翠絲	翠丝
聊斋之九州伏魔录	捉妖战记
上海1948	天落水
三只虫草	少年桑吉
陈鸿宇巴士巡演纪录片	行歌·年轻人
喧哗至上	再见路星河
圣蛋传奇	圣蛋传奇之猪公的骰子
猪公的骰子	圣蛋传奇之猪公的骰子
赌神2018	美少女赌神
回溯	回溯者
酸菜泡菜配	为你写诗
山村姑娘3之人在江湖	奇女子之人在江湖
小城一梦	小城一梦之臭棋乱飞象
女神学院	不良千金
末栈第二部	末栈之黑水
末栈第三部	末栈之望子成龙
末栈第四部	末栈之重生
杨家将七郎八虎之杨六郎智破连环计	杨六郎智破连环计
伍兰英	铭心岁月
萌乖夫君养成记	少女茯苓1：萌乖夫君养成记
老地方	匆匆那年之老地方
嘻哈派对夜(港)	余兴派对
嘻哈续摊趴(台)	余兴派对
怪物与凡人	怪物与人
网诱危机	网诱惊魂
网络危机	网诱惊魂
人心简介	网诱惊魂
简介	网诱惊魂
账户	网诱惊魂
少女茯苓2	少女茯苓2：七生七世桃花劫
清水河	见证清水河
邪气凛然	混混英雄
世界第一联盟之赌徒VS超能力者	世界第一系列之赌神VS超能力者
竞赛	爱情比赛
说走就走之毕业旅行	说走就走之不说再见
小戏骨之包青天	小戏骨：包青天之铡庞昱
大梦西游番外之拯救悟空	拯救悟空
封仙册之牛魔大王	封神册系列之三
无相之战	神探云笔记1
秘境之城	神探云笔记2
梦的第四区	记忆折叠
之华	你好，之华
我们这些动物	我们，动物
人肉搜寻(港)	网络谜踪
人肉搜索(台)	网络谜踪
搜索	网络谜踪
屏幕搜索	网络谜踪
海军陆战队员6	海军陆战队员6：近距离击杀
赣水苍茫闽山红	闽赣风云
罗振宇《时间的朋友》2017跨年演讲	深圳卫视“时间的朋友”2017跨年演讲
石头记	无陵之山
青春嗨18跨年演唱会	2018湖南卫视跨年演唱会
暴走大事件第五季特别篇	暴走超大事件
嫁衣凄谈	黄庙村之魔棺新娘
2018广东卫视跨年演讲	更好的明年
财经郎眼2017跨年演讲	更好的明年
二流太傅之楼兰玉麒麟	二流太傅：楼兰玉麒麟
人面魚：紅衣小女孩外傳	人面鱼：红衣小女孩外传
红衣小女孩3	人面鱼：红衣小女孩外传
烏鴉燒	乌鸦烧
M.I.A.从难民到歌手（港）	玛琪，玛雅，米娅
革命／嘻哈／M.I.A.(台)	玛琪，玛雅，米娅
真爱拼拼图(台)	拼图
宿怨(台)	遗传厄运
祖孽(港)	遗传厄运
厄运遗传	遗传厄运
刀剑俏娇娃	带刀片的婴儿
小宋和李逵逵	小宋与李逵逵
青春纪之留爱到明天	青春纪
少年僵尸	僵尸高校
2018湖南卫视小年夜春晚	2018湖南卫视春节联欢晚会
2018湖南卫视春晚	2018湖南卫视春节联欢晚会
杀无赦II	杀无赦II逃亡之路
杀无赦2	杀无赦II逃亡之路
杀无赦III	杀无赦III背水一战
杀无赦3	杀无赦III背水一战
血、汗和谎言	凶手教练
你是我生命中的一首歌	我们最好的时光
老师好	我们最好的时光
非同凡響	非同凡响
平和少年	秋枫
平和少年	秋枫
岛	江心岛
小戏骨之哪吒传奇	小戏骨：哪吒传奇
小戏骨：哪吒传奇篇	小戏骨：哪吒传奇
吃貨神探之獵獸行動	吃货神探之猎兽行动
噬膽72	噬胆72
我的Mr. Right	我的真命天子
轨计	妻诈
河东狮吼	白发魔女大战东方不败
租约	致命妄想
家(音乐剧)	家
龙头接班人	扫黑神探
乌盆记	一代妖狐
第一章	天启
保龙一族之龙游浅水	保龙一族之龙游潜水
買一送一	买一送一
萬千星輝頒獎典禮2017	万千星辉颁奖典礼2017
認知障礙知多D	认知障碍知多点
白日依山尽	白日与山尽
爱心快递	美丽的心灵
济公之捉妖降魔	济公之英雄归位
带刺的鱼	鱼骨头
聊斋狐媚传	聊斋媚狐传
野人之雨林决	野人之雨林诀
爆裂拳手	罪拳
完美情人	来自你的瓦伦汀
步步惊心	命悬一线
大山里的春天	大山里的穿天
狂暴的丧失	狂暴的感染者
去钓鱼	走，去钓鱼！
新国产凌凌漆之神探房东	神探房东
幻醒	活罪无期
一家亲亲过好年	疯狂这一年
孟婆选妃记	驱忘使者上位记（上）
孟婆选妃记	驱忘使者上位记（下）
走私运毒者	骡子
賭命運轉手(台)	骡子
御宠娇妃2	御宠娇妃2绝代偃师
醉有应得,亦正亦邪	醉有应得
骨笛魔音	探案录骨笛魔音
2018國際中華小姐競選	2018国际中华小姐竞选
淪落人	沦落人
2015國際中華小姐競選	2015国际中华小姐竞选
女神捕系列	侠义神捕之请君入瓮
女神捕系列	侠义神捕之诡影
小贝流浪记电影版	猫咪小贝
江南女儿（港）	江南弃儿
天乩白蛇后传之拯救天帝	天乩之白蛇后传
功夫四侠2	功夫四侠：勇闯地宫
狗狗傷心誌	狗狗伤心志
介错人	不良街区
尋路航海	寻路航海
地球に落ちてきた裸女	ピンク・ゾーン
画江湖之风语咒	风语咒
殺手不笨	杀手不笨
潜艇总动员6	潜艇总动员：海底两万里
2018辽视春晚	2018年辽宁卫视春节联欢晚会
绝地逃亡	私运之人
山岭狂奔者	私运之人
山炮三剑客	老男人也疯狂
2018山东卫视春节联欢晚会	幸福出发
2018安徽卫视春节联欢晚会	江淮欢腾新时代
2018安徽春晚	江淮欢腾新时代
荣耀	荣誉
如果	武装
黑街报告	实地笔记
不能唤醒的爱	三生三界情人劫
我繼續	我继续
四海同春 2018全球华侨华人春节大联欢	文化中国
2018东方卫视春节晚会	春满东方
Go幸福 2018北京卫视春节联欢晚会	Go精彩
2018江苏卫视春节联欢晚会	幸福中国年
新春開運迎豐年	新春开运迎丰年
被遗忘的友谊 My Little Pony Equestria Girls: Forgotten Friendship	小马国女孩
江湖三刀之刀山火海	刀山火海
2017國際中華小姐競選	2017国际中华小姐竞选
剧场版	我是江小白
我是江小白小剧场	我是江小白
我是江小白：世界上的另一个我	我是江小白
我是江小白OVA	我是江小白
大叔和房子	合群路
陶泩	陶先生
愛は地獄から来た犬	爱情是一只来自地狱的狗
詩季織々	肆式青春
诗季织织	肆式青春
赌局风云之诈和	赌局风云2017
有一种青春叫高考	青春期2决战高考
WWE 密室铁笼淘汰赛 2018	WWE:铁笼密室
再见18班	再见十八班
守護寶地	守护宝地
隔壁的学士	隔壁的单身汉
名单	大智若愚
2017年陕西卫视春节联欢晚会	2017年丝路春晚
丝路春晚	2017年丝路春晚
普莱西德湖：传奇	史前巨鳄遗产
神童	超能奇才
三娘传说	上古仙女秘闻
七仙女之三娘传说	上古仙女秘闻
2008湖南卫视春节联欢晚会	2008湖南卫视小年夜春晚
2008湖南卫视春晚	2008湖南卫视小年夜春晚
悲歌	不涉江湖
奇缔微商小姐妹	闺间密语
爱是永恒	爱，一往情深
飘飘‘灵’距离	飘飘零距离
飓风婊咖2：莫斯科只有眼泪	飓风比安卡：恨你的俄罗斯
小戏班：杨门女将之女将初征	杨门女将之女将初征
小戏班：杨门女将	杨门女将之女将初征
她们的秘密	闺蜜
兄弟	哥哥
市長夫人的秘密	市长夫人的秘密
我想有个家(台)	迦百农
千万别出门	切勿离家
这个演员是杀手	冒牌杀手
魂飞胆破8	魂飞胆破8：血之幽灵
中秋之夜全球模仿秀	王者归来
2018电视剧品质盛典	剧耀东方
愛．革命	暴走曼谷
爱·革命	暴走曼谷
（家政侦探社）	跑吧！兄弟
断魂枪之剿匪龙虎山	剿匪龙虎山
那时天晴	飞越网戒所
秃鹰俱乐部	毒蛇俱乐部
有一種喜歡	有一种喜欢
午夜杂货铺	心想事成杂货铺
2017香港小姐競選	2017香港小姐竞选
淅川大移民	渠首欢歌
大宋断狱神手	大宋断狱神手之陈情伞
2018超級巨星紅白藝能大賞	2018超级巨星红白艺能大赏
2016國際中華小姐競選	2016国际中华小姐竞选
WWE 摔角狂热 2018	摔角狂热
水浒传之智取生辰纲	水浒之智取生辰纲
我的未来谁作主	我的未来谁做主
望星空	我的未来谁做主
水深火热2	深海狂鲨2
深海变种2	深海狂鲨2
深蓝的海洋2	深海狂鲨2
深海恶鲨2	深海狂鲨2
移动新迷宫	恐怖轮回
水浒英雄人物谱之桃花小霸王	桃花小霸王
魔国志II之神魔无双	魔国志2
女大十八变之五彩梦	五彩梦
天镇兰花花	兰花花啊
杨戬传	封魔纪之杨戬传
妙探乌龙计	妙探乌龙记
不良校花	青春没有彩排
包姚	巴哈
第29届金曲奖颁奖典礼	第29届金曲奖
金曲二九	第29届金曲奖
第55屆金馬獎頒獎典禮	第55届金马奖颁奖典礼‎
皮皮鲁送你100条命	皮皮鲁安全特工队
皮皮鲁总动员	皮皮鲁安全特工队
共乘	顺风车
心灵感应	未来的你
如果鯊魚沒有牙齒	如果鲨鱼没有牙齿
启航	来不及拥抱
我弹要你唱	娜娜娜
纪念王小波逝世15周年	寻找黄金时代
千古一后	千古一后：武则天
前兆	我要去远方
雾都神探	雾都神探之绝情箭
新大头儿子和小头爸爸3	新大头儿子和小头爸爸3：俄罗斯奇遇记
Goodbye(英)	燈火
实在舍不得	让我怎么相信你
伏妖·白鱼镇之斗法金银楼	伏妖白鱼镇2
伏妖·白鱼镇2	伏妖白鱼镇2
血洒江阴	1937海空大血战
夜につがう人妻	性の逃避行
通灵晚宴	晚餐聚会
我在齐国谈恋爱	战国奇缘
寄生游戏	寄生夙愿
耙子	铁耙
鲨卷风6	鲨卷风6：最后的鲨卷风
史前巨鲨	巨齿鲨山寨版
侏儸紀世界：三疊紀國度(台)	三叠纪世界
最强王者	王者联盟
黄子华栋笃笑之金盆啷口	黄子华栋笃笑之金盘
独家记忆	快照
爱如此醉人	爱是永恒
猛男3條半	猛男三条半
黄飞鸿之生化人	黄飞鸿之南北英雄
阿凡提	阿凡提之奇缘历险
傻傻愛你，傻傻愛我	傻傻爱你，傻傻爱我
Le Mirage（法）	蜃楼
Mirage（英）	蜃楼
孤隐刀	刀震江湖
剑客	风流剑客
这！就是街舞之天生舞者	天生舞者
特侦行动-逆向谋杀	逆向谋杀
加利福尼亚鱼缸	鱼缸加州
一个人的门派	一个人的江湖
筑梦新时代：2018年“五月的鲜花”全国大中学生文艺会演	筑梦新时代
屌丝崛起	黑马
葫芦侠大战魔灵	葫芦兄妹大战魔灵
天上有海	蓝色金鱼
特种乞丐之拯救萝莉	极限拯救
罪途2	罪途2之救赎代价
罪途II之救赎代价	罪途2之救赎代价
罪途之救赎代价	罪途2之救赎代价
期皮瓦克	史碧华克爱恨交加的人生
终极杀戮	大杀特杀
特种使命之怒海潜龙	怒海潜龙
罪途3	罪途3之正义规则
罪途III之正义规则	罪途3之正义规则
罪途之正义规则	罪途3之正义规则
我杀了我妈吗？	我杀了我的母亲吗？
我杀了我妈？	我杀了我的母亲吗？
第三辑 Star Wars Forces of Destiny: Volume 3	星球大战：命运的力量
禁忌书院	箫魂传3之禁忌书院
箫魂传3禁忌书院	箫魂传3之禁忌书院
箫魂传之禁忌书院	箫魂传3之禁忌书院
赤雷传	封魔纪之赤雷传
安菟！安菟！	安菟！安菟！
铁头无敌	陈翔六点半之铁头无敌
學長	学长
赤雷传	封魔纪之赤雷传
吉屋出租	吉屋
天才教授	疯狂的麻将
疯狂麻将	疯狂的麻将
破碎梦想的集合	碎梦汇编
迷失的女孩	困惑女孩
黑豹：瓦坎达危机 LEGO Marvel Super Heroes: Black Panther - Trouble in Wakanda	乐高漫威超级英雄
八仙 3D	八仙
小悟空 3D	小悟空
小金刚纽约大冒险	小悟空
纽约行者	小悟空
禹神传：寻找神力	禹神传之寻找神力
The Persuit Of Love（英文名）	大喜盈门
微影旅行	微影驴行
网络红人(港)	禁入直播
出柜炸弹	蕾丝炸弹
“滚出来，凶手”之盗婴案	盗婴之谜
“滚出来，凶手” 之蜃楼案	蜃楼谜香
萌娃呆爸之一路上有你	呆爸萌娃
新蜀山剑侠传电影版	新蜀山剑侠传
“滚出来，凶手” 之尸踪案	靡音之罪
泰山恋	山水恋人
爱在你消失以后	爱在你消失之后
XOXO卡夫卡	爱上卡夫卡
夺宝七日	侠路相逢
綁架外星人(台)	阿斯特罗
乡村法制剧场：净身出户	净身出户
同人ドラえもん のび太のヒマラヤ行進記	同人哆啦A梦：大雄的喜马拉雅行进记
无敌镖客之兄弟情深	无敌镖客
无敌镖客之兄弟情深	无敌镖客
红日亭	温暖之城之红日亭
往事不能回味	白夜最长时
猛女复仇续集	死里逃生
土行孙传	封魔纪之土行孙传
第70届艾美奖颁奖典礼	第70届黄金时段艾美奖颁奖典礼
深宫怒	乱世后宫：红发美人
启示录：上升	启示录叛乱
酬简	西厢记
校园励志电影《绽放》	绽放
告别昨天	告别昨天的我们
妈妈再打我一次	两个妈妈
王子猎爱记	王子的替身情人
丝路仙都	任法融和他的丝路仙都
暗游记1不良厨娘	暗游记之不良厨娘
第二季金投赏品牌命题大赛纪录片	信任是金II纪录片
一舞定钟情	一见钟情
海雀	文朝荣
金色的鲤鱼	金鲤鱼
疯狂女友	不良女友
此生再不归太行	太行
初恋从憋气开始	校花的泳装派对
玩的就是潘金莲	女神潘金莲玩穿越
潘金莲穿越	女神潘金莲玩穿越
大有快跑	拐个公主回大唐
幽灵情人	夜伴情人
爆裂女警	夺命追凶
未见那些年	未见再见
Murder（英）	周末旅行团
谜镇1	谜镇1流星杀人案件
瘟疫	流行病
《杀了我》续集	查无此人
灵媒师之怖偶	灵媒师
灵界基友3怖偶	灵媒师
轮回碎片	异星契约
希望家园电影版	希望家园
夺命剑2之喋血江湖	夺命剑之喋血江湖
黑森林	无处逃离
拼爹游戏	年度老爸
曼陀罗	故人如梦
男生宿舍	解剖室灵异事件之男生宿舍
黄雀在后	无处逃离之黄雀在后
盛夏．秋豐	盛夏．秋丰
獵人獵人	猎人猎人
我們的月亮	我们的月亮
追月	山海伏魔之追月
汪曾祺纪录片	梦故乡
这就是人工智能	纪录·人工智能
栗子狗	栗子狗和香蕉狐
三人刑	暴走杀手
《战狼三级班》	战狼三级班
乡村法制剧场之欲望船屋	欲望船屋
E.T. 悲伤乐园	我儿子去了外星球
超能记者	石狮之超能记者
咪咪莱回咬	食人族女王
法海传	缉妖法海传
霸气女销售之女销售的梦想	女销售的梦想
冲出亚洲的女销售之女销售的梦想	女销售的梦想
宝贝有戏：七仙女之仙女下凡	七仙女之仙女下凡
宝贝有戏：七仙女	七仙女之仙女下凡
吃谜少女剧场版1	溺亡大厦
GROUP第五届偶像年度人气总决选演唱会	“砥砺前行”SNH48
塞纳河五选	“砥砺前行”SNH48
黑水谈之巢	黑水谭之巢
心魔師	心魔师
心魔师之小羊玛丽杀人事件	心魔师
小羊玛丽杀人事件	心魔师
韩路游记：阿尔金山保护区科考之旅	韩路游记
絕世情歌	绝世情歌
齐天大圣2	齐天大圣·火焰山
新版监狱风云	监狱风云之云淡风轻
親愛的卵男日記	亲爱的卵男日记
亲爱的遗腹子	亲爱的卵男日记
乡村法制剧场之骗婚男女	骗婚男女
侠骨游医之偷心者	偷心者
美国政道	美国达摩
偷换人生(港)	蝠鲼
曼塔射线	蝠鲼
沉默者	消音器
2018香港小姐競選	2018香港小姐竞选
西游释厄传	西游·三藏前传
希望之泉永不尽	希望永不止息
2005卡通春节联欢晚会	虹猫蓝兔闹新春
印度传奇故事7之灵蛇战	灵蛇战
蛇战	灵蛇战
印度传奇故事 96版	灵蛇战
郪遇记	避尘珠
宏梦卡通天地：蛇舞新春闹翻天	蛇舞新春闹翻天
染为红色	把它漆成红色
第二季	我爱你中国
致命反击	致命还击
电影版 Constantine: City of Demons	康斯坦丁：恶魔之城
甩尾王2之王者归来	甩尾王2
侦探笔记	神探风云
艺术民工2——打破幻想	艺术民工2
塘沽•我爱你	塘沽我爱你
被诅咒的京戏班	鬼咒
1941的聖誕	1941的圣诞
斗玉之玉魂师	玉魂师
中国唱诗班：夜思	夜思
九龙壁	夺钻狙击
防蚊貼片	防蚊贴片
爱心传达	追光少女
小白船	小白舟
约车惊魂夜	搭车
真实的Gemma	另一边
玄武迷踪之连环斗	古墓兽影
月半咖啡	盗梦魅影
再见	你好
歸去來兮	归去来兮
自選片單	自选片单
一波三折的友谊 My Little Pony Equestria Girls: Rollercoaster of Friendship	小马国女孩
在他离去前	桔煦如衷
末世录	降魔武僧
夜行医手札	降妖天师
共和国战争	中越边界战争纪实
每一朵花	每一朵花儿
男与女	女人,有时是男人
天外来的铁血战士	异星的铁血战士
异星掠夺者	异星的铁血战士
侠骨游医之东宫毒	东宫毒
地狱之门	天堂阶梯与地狱之门
真情无限	李司法的冬暖夏凉
侠骨游医之英雄帖	英雄帖
侠骨游医之还魂砂	还魂砂
半熟少女薇薇安	薇薇安
重甲機神	重甲机神
夺宝七日	侠路相逢
宝贝有戏之七仙女下凡	宝贝有戏之七仙女
圣诞大件事(港)	拯救圣诞记
圣诞急救队(台)	拯救圣诞记
冬天里的冰激凌	冬天的冰激凌
三个丈夫	三夫
回到故乡	六郎
Eskimo Sisters(剧本名)	香蕉船
大漠战将——班超	大漠战将班超
侠骨游医之救婴记	救婴记
侠骨游医之龙吟诏	龙吟诏
死んだ川蓮と彼のロック	死去的川莲和他的摇滚
第一次告别	第一次的离别
路遇不熟	云雾笼罩的山峰
罪中罪	云雾笼罩的山峰
叫我陳太	叫我陈太
青春不苟活	青春不狗活
开封降妖记	开封降魔记
第一次告别	第一次的离别
第一次告别	第一次的离别
台湾より愛をこめて	再一次，台湾见
再一次，台灣見	再一次，台湾见
叛徒	背叛
出卖	背叛
出卖风云	背叛
区块链的故事 Trust Machine: The Story of Blockchain	信任机器:
風從哪裡來	风从哪里来
強大的我	强大的我
練習溫柔	练习温柔
牛哥的故事之一	牛哥的故事之一别了冬天
没有回信	沒有回信
倩狐传第二季	倩狐传2
倩狐传第三季	倩狐传3
过往年光	你在清浅年光时
那些女孩教我的事	那时的我们
风中有朵雨做的云纪录片	梦的背后
搖擺布魯克林(台)	摇摆布鲁克林
所有我能記得的事(台)	所有我能記得的事
情趣店奇妙夜	天黑以后
情趣店奇妙夜	天黑以后
瞳灵公馆	阴阳眼之瞳灵公馆
莫欺少年穷	励志少年
蝎子王5	蝎子王5:灵魂之书
第29届中国电视金鹰奖颁奖典礼	第12届中国金鹰电视艺术节颁奖典礼
朝花夕拾.芳华绝代	拾芳
夢	梦
江城故事之假面	江城故事之局中局
消失的女人	寒冰
上影版四大名捕	四大名捕之入梦妖灵
幽灵情人	夜伴情人
恐怖森林	林中惊魂
惊悚森林	林中惊魂
野兽女孩	克里斯塔
狂恋高跟鞋	马路与天使
寄生游戏	寄生夙愿
探魔导师2王者联盟	探魔导师2之王者联盟
2018亞洲小姐競選香港區決賽	2018亚洲小姐竞选香港区决赛
紅毯的那一端	相愛容易相處難：同居時代/
愛情這種小事	相愛容易相處難：同居時代/
Love is not That Easy! (英)	相愛容易相處難：同居時代/
解忧烘培坊	烘培坊
面包工厂，第一部：为了黄金	面包工厂，第一部分
你，不止是你	你不止是你
偷偷爱上你	33号公路
第四季	遇见大咖
紅鼻子與小女孩	红鼻子与小女孩
德云社壬辰年封箱庆典专场演出	德云社壬辰年封箱庆典
2016香港小姐競選	2016香港小姐竞选
2018天猫双11晚会	2018天猫双十一狂欢夜
变形计 第十六季	变形计青春攻略
2018变形计	变形计青春攻略
兜乱公主闯情关(港)	公主大对换
公主闹双包(台)	公主大对换
チベット・遥かな心の旅 ～中国～	西藏孤儿心之旅
～川普政权与媒体的攻防战～ ＮＹタイムズの100日間 ～トランプ政権とメディアの攻防～	纽约时报的100天
神龙大师	神龙之战
中国版《完美陌生人》	来电狂响
手机狂响	来电狂响
维密秀2018	维多利亚的秘密2018时装秀
中国版《完美陌生人》	来电狂响
手机狂响	来电狂响
童心似火	蜻蜓少年
我的小马驹：最棒的礼物	我的小马驹：2018圣诞特辑
外星霸主	异族领主
外来统治者	异族领主
外星人霸主	异族领主
伏妖·白鱼镇之斗法金银楼	伏妖白鱼镇2
伏妖·白鱼镇2	伏妖白鱼镇2
德克萨斯棉花	德州棉花
圣诞王子：皇家婚礼(港	圣诞王子：皇室婚礼
台)	圣诞王子：皇室婚礼
诡宅丽影之墓野迷踪	墓野魅影
沦陷雨乡	雨中的秋城
秋城	雨中的秋城
雨乡流年	雨中的秋城
Ellen DeGeneres：感同身受	艾伦·德杰尼勒斯：感同身受
封神降魔2	封神降魔2桃山气海
封神降魔之桃山气海	封神降魔2桃山气海
第二季：璀璨明珠	广府春秋
广府春秋·璀璨明珠	广府春秋
广府春秋 第二季	广府春秋
广府春秋II	广府春秋
璀璨明珠	广府春秋
总裁别太坏2替嫁娇妻	替嫁新娘
第十五届中国金鸡百花电影节闭幕式文艺晚会	第15届中国金鸡百花电影节颁奖典礼
陇原妹子	天水来的姑娘
死侍2（PG-13特别版）	死侍2阖家欢乐版
娇娃护宝	护宝
哈囉！有事嗎	哈喽！有事吗
红日亭	温暖之城之红日亭
王牌教師麻辣出擊	王牌教师麻辣出击
麻辣鲜师重返校园	王牌教师麻辣出击
· 我们的40年	去远方
我们的40年之去远方	去远方
值得	价值
人间值得	价值
奇葩狂想曲	龙泉路237号青春轶事
虐恋倾城	天黑别看我的脸
皮条客	女皮条客
