谢耳朵	吉姆·帕森斯
詹姆斯·约瑟夫·吉姆·帕森斯	吉姆·帕森斯
馬修·古迪	马修·古迪
馬修·古德	马修·古迪
莉莉阿姨	艾丽森·汉妮根
法鲨	迈克尔·法斯宾德
法叔	迈克尔·法斯宾德
米高法斯宾达	迈克尔·法斯宾德
米夏埃尔·法斯本德	迈克尔·法斯宾德
亚历山大·雷·鲍德温三世	亚历克·鲍德温
米歇尔·莫娜汉	米歇尔·莫纳汉
米雪·慕娜汉	米歇尔·莫纳汉
米歇尔·琳恩·莫娜汉	米歇尔·莫纳汉
蜜雪儿·摩纳汉	米歇尔·莫纳汉
铃湖湖	蕾克·贝尔
莱斯利·曼	莱斯利·曼恩
湖南	查理·汉纳姆
艾薇儿	艾薇儿·拉维尼
莲娜欧琳	莉娜·奥琳
詹姆斯·卡安	詹姆斯·肯恩
谢玛·摩尔	谢默·摩尔
布伦丹·格利森	布莱丹·格里森
布伦丹·格里森	布莱丹·格里森
寇森（昵称）	克拉克·格雷格
克拉克 格拉格	克拉克·格雷格
迈克尔·彼特	迈克尔·皮特
杰茜卡·兰格	杰西卡·兰格
潔希卡·蘭芝	杰西卡·兰格
娜塔莎·里奥尼	娜塔莎·雷昂
娜塔莎·雷奥恩	娜塔莎·雷昂
山姆·华盛顿	萨姆·沃辛顿
山姆·沃什英顿	萨姆·沃辛顿
山姆·沃思因顿	萨姆·沃辛顿
宋康	姜成镐
成康	姜成镐
凯瑟琳·麦克菲	凯瑟琳·麦菲
威尔·尹·李	李威尹
李相玉	李威尹
大姑妈（昵称）	埃尔顿·约翰
阿沙·布特菲尔德	阿萨·巴特菲尔德
阿沙·巴特菲尔德	阿萨·巴特菲尔德
杰西卡·查斯坦荫	杰西卡·查斯坦
杰西卡·查斯汀	杰西卡·查斯坦
劳模姐	杰西卡·查斯坦
蒂凡妮·都彭	蒂凡尼·多庞特
玛丽亚·巴尔韦德	玛利亚·瓦沃德
玛利亚·巴尔波尔德	玛利亚·瓦沃德
玛莉亚·瓦维德	玛利亚·瓦沃德
布鲁诺·冈茨	布鲁诺·甘茨
毒蛇	兰迪·奥尔顿
諾拉·鍾斯	诺拉·琼斯
杰夫·邓纳姆	杰夫·唐纳姆
华特·沙勒斯	沃尔特·塞勒斯
沃尔特·萨雷斯	沃尔特·塞勒斯
和路达沙利	沃尔特·塞勒斯
华特萨勒斯	沃尔特·塞勒斯
瑞恩·辛普金斯	芮安·辛普金斯
唐蕊莉	汤姆·莱利
琴嘉	杰佳·亚宁
琴嘉·亚宁	杰佳·亚宁
姬佳·雅宁	杰佳·亚宁
彼得·摩根	皮特·摩根
苏珊娜·毕叶尔	苏珊娜·比尔
范妮莎·布兰奇	瓦妮莎·布兰奇
米格尔·安格·希尔维斯特	米格尔·安赫尔·西尔维斯特
加德·埃尔玛勒	加德·艾尔马莱
加德·埃尔马莱	加德·艾尔马莱
伊莎贝尔·库伊谢特	伊莎贝尔·科赛特
赵卓	赵文卓
老徐	徐静蕾
静蕾	徐静蕾
蕾蕾	徐静蕾
火华社社长	刘烨
罗 博斯	罗纳德·巴斯
田十八	陈果
水果	陈果
康奴·門多佐	凯内尔·穆德卢佐
山P	山下智久
青木智久	山下智久
拜伦·戴维斯	巴朗·戴维斯
葛憂	葛优
优子	葛优
葛大爷	葛优
戴维·M·罗森塔尔	大卫·M·罗森索
梁碧姿	梁咏琪
高妹	梁咏琪
小董老师	董洁
张家振	张睿家
刘凡平	刘心悠
泰勒·艾莉森·斯威夫特	泰勒·斯威夫特
泰勒·史薇芙特	泰勒·斯威夫特
泰勒·斯威芙特	泰勒·斯威夫特
霉霉	泰勒·斯威夫特
崔珉洙	崔民秀
崔民洙	崔民秀
小室博义	叶山豪
八武崎碧	悠木碧
凹酱	悠木碧
阿德里安·布劳迪	艾德里安·布洛迪
亚德里安·布罗迪	艾德里安·布洛迪
阿德里恩·布洛迪	艾德里安·布洛迪
艾哲倫保迪	艾德里安·布洛迪
克利斯丁·格拉夫	克里斯平·格洛弗
保罗·鲁德	保罗·路德
西斯·罗根	塞斯·罗根
赛斯·罗根	塞斯·罗根
薜夫·洛根	塞斯·罗根
埃里克·罗伯兹	埃里克·罗伯茨
大卫·约翰·麦克唐纳德	大卫·田纳特
大衛·泰南	大卫·田纳特
爱迪梅菲	艾迪·墨菲
丹尼斯奎尔（台	丹尼斯·奎德
港）	丹尼斯·奎德
便当之王	肖恩·宾
豆叔	肖恩·宾
史蒂文·史葛	史蒂文·席格
斯蒂芬·西格尔	史蒂文·席格
罗恩·帕尔曼	朗·普尔曼
克里斯多夫·兰伯特	克里斯多弗·兰伯特
克里斯托弗·兰伯特	克里斯多弗·兰伯特
玛莉·珊顿	玛丽·谢尔顿
帕特里夏·阿奎特	帕特丽夏·阿奎特
帕特里夏·阿盖特	帕特丽夏·阿奎特
夏大雷	威廉·夏特纳
安迪·塞基斯	安迪·瑟金斯
安迪·瑟克斯	安迪·瑟金斯
迈克·纽厄尔	迈克·内威尔
卢卡斯·汉斯	卢卡斯·哈斯
埃德加·莱特	埃德加·赖特
马修·摩丁	马修·莫迪恩
乔伊.劳伦斯	约瑟夫·劳伦斯
黛安娜·维斯特	黛安·韦斯特
布雷特·拉特纳	布莱特·拉特纳
竹井乔治	武井乔治
武井穗乡	武井乔治
彼得‧卡帕爾蒂	彼得·卡帕尔迪
巴里·索南费尔德	巴里·索南菲尔德
巴里·利维逊	巴瑞·莱文森
金·伯德尼亚	金·波德尼亚
马克· 赖德尔	马克·雷戴尔
黄加达	黄家达
桃井熏	桃井薰
汉斯·克里斯蒂安·安徒生	安徒生
王正权	王羽
王中和	王童
米娜·古妮丝	米拉·库尼斯
米拉·库妮丝	米拉·库尼斯
保罗·贝特尼	保罗·贝坦尼
丹尼尔·域卡夫	丹尼尔·雷德克里夫
丹	丹尼尔·雷德克里夫
丹尼尔·雅各布·雷德克里弗	丹尼尔·雷德克里夫
凯萨琳·贝利·贝金塞尔	凯特·贝金赛尔
休·约翰·曼格·葛兰	休·格兰特
休·葛蘭	休·格兰特
曉·格蘭特	休·格兰特
张发忠	张国荣
张发宗	张国荣
哥哥	张国荣
荣少	张国荣
十仔	张国荣
小林青霞	张柏芝
张栢芝	张柏芝
毛毛	陈豪
田原	田沅
麦克·什恩	麦克·辛
迈克尔·西恩	麦克·辛
迈克尔·什恩	麦克·辛
迈克尔·辛	麦克·辛
迈克尔·豪	迈克尔·C·豪尔
迈克尔·豪尔	迈克尔·C·豪尔
维多利亚·贾斯蒂斯	维多利亚·嘉丝蒂
艾希姆斯	艾德·赫尔姆斯
爱德华·帕克·赫姆斯	艾德·赫尔姆斯
布布·斯图尔特（又译） 小尼尔斯·艾伦·斯图尔特（本名）	波波·斯图尔特
邦妮·维特	邦妮·怀特
邦妮·韦特	邦妮·怀特
珀妮·莱特	邦妮·怀特
邦妮·赖特	邦妮·怀特
蕾切尔·李费佛	蕾切尔·勒费夫尔
丽雪拉菲芙	蕾切尔·勒费夫尔
夏兰·海因兹	塞伦·希德
珍妮弗·贾森·利	詹妮弗·杰森·李
莫莉·林沃德	莫利·林沃德
莫莉·林瓦尔德	莫利·林沃德
布·雷諾斯	伯特·雷诺兹
抖森	汤姆·希德勒斯顿
汤·希丹士顿	汤姆·希德勒斯顿
汤姆·希德尔斯顿	汤姆·希德勒斯顿
娜塔莉·多默	娜塔莉·多默尔
小玫瑰	娜塔莉·多默尔
玛格丽塔·弗拉基米洛夫娜·列维耶娃	玛格丽塔·列维耶娃
伊万·彼得斯	埃文·彼得斯
艾伦·德詹尼丝	艾伦·德杰尼勒斯
东尼·嘉	托尼·贾
基莉·霍斯	凯莉·霍威
贾斯汀·哈特利	贾斯汀·哈特雷
当当，当爷	亚当·兰伯特
比尔·马尔	比尔·马厄
比尔·马赫	比尔·马厄
威尔·普特尔	威尔·保尔特
格里泰·斯卡绮	格列塔·斯卡奇
马赫莎拉哈什巴兹·阿里	马赫沙拉·阿里
里奇·索摩	里奇·索莫
瑞恩·平克斯通	瑞恩·平克斯顿
卡里奥·托马斯	科里奥·托马斯
卢克·葛莱姆斯	卢克·葛莱姆斯
杰森·温斯顿·乔治	杰森·乔治
凯特·波斯沃斯	凯特·波茨沃斯
夏林	王菲
王靖雯	王菲
奥黛丽·多杜	奥黛丽·塔图
奥黛莉·朵杜	奥黛丽·塔图
柯德莉·塔图	奥黛丽·塔图
奥德丽·多杜	奥黛丽·塔图
梅尔维·珀波	梅尔维尔·珀波
奥莉薇娅·柯尔曼	奥利维娅·科尔曼
马丁·伍特克	马丁·乌特克
米兰达·裘莱	米兰达·裘丽
艾路摩里斯	埃罗尔·莫里斯
小乔治·蒂尔曼	小乔治·提尔曼
钟欣桐	钟欣潼
阿娇	钟欣潼
钟小娇	钟欣潼
钟嘉励	钟欣潼
锺狄珊	钟欣潼
克里斯丁·杰夫	克莉斯汀·杰弗斯
猫的力量	猫女魔力
吴安雅	安雅
亨利·嘉格隆	亨利·雅格洛
陈咏悯	苗可秀
吉奥夫·约翰斯	乔夫·琼斯
姐夫	乔夫·琼斯
小洁	李心洁
靓妹	李心洁
钱嘉华	钱小豪
维吉尼亚·沃尔夫	弗吉尼亚·伍尔芙
拳也	泽田谦也
阿璇	叶璇
小璇子	叶璇
海马	叶璇
刘添爵	刘永
刘勇	刘永
克里斯琴·贝尔	克里斯蒂安·贝尔
克里斯汀·贝	克里斯蒂安·贝尔
克里斯汀·查尔斯·菲力普·贝尔	克里斯蒂安·贝尔
基斯頓比爾	克里斯蒂安·贝尔
佩妮洛普·克鲁兹	佩内洛普·克鲁兹
佩内洛佩·克鲁斯	佩内洛普·克鲁兹
潘尼洛普·克鲁兹	佩内洛普·克鲁兹
潘娜洛普·克鲁兹	佩内洛普·克鲁兹
彭妮露·古絲	佩内洛普·克鲁兹
李冬冬	阿部力
李振冬	阿部力
加護亜依	加护亚依
鍾淑慧	钟淑慧
朱凯莉	恬妞
艺智媛	艺智苑
芮智苑	艺智苑
芮智媛	艺智苑
金正勋	金桢勋
金政勋	金桢勋
冯丽莎	邝丽莎
丽莎·泗	邝丽莎
裕善	柳善
小马哥	马景涛
咆哮马	马景涛
马大姐	马景涛
靓仔杰	蔡一杰
草蜢	蔡一杰
雷夫·费因斯	拉尔夫·费因斯
雷夫·范恩斯	拉尔夫·费因斯
雷夫·纳撒尼尔·特威斯尔顿-威克姆-范恩斯	拉尔夫·费因斯
雷夫·纳旦尼尔·土伊斯勒顿-维克汉-范恩斯	拉尔夫·费因斯
占士·麦艾禾	詹姆斯·麦卡沃伊
詹姆斯·麦艾维	詹姆斯·麦卡沃伊
詹姆斯·麦克沃	詹姆斯·麦卡沃伊
詹姆斯·麦克沃伊	詹姆斯·麦卡沃伊
詹姆斯·迈卡沃伊	詹姆斯·麦卡沃伊
一美	詹姆斯·麦卡沃伊
欧文·威尔森	欧文·威尔逊
斯塔茜·达什	斯黛西·达什
尼克·诺尔蒂	尼克·诺特
鲁格·豪尔	鲁特格尔·哈尔
简·西摩尔	简·西摩
珍·西摩尔	简·西摩
米高曼	迈克尔·曼
迈可曼	迈克尔·曼
华仔	大卫·斯特雷泽恩
西碧尔·谢波德	斯碧尔·谢波德
斯科特·格林	斯科特·格伦
夏绿蒂·兰普琳	夏洛特·兰普林
内森·雷恩	内森·连恩
派珀·劳里	派珀·劳瑞
范雯芳	范文芳
宝贝	范文芳
大野洋子	小野洋子
尼尔斯·阿雷斯特吕普	尼尔斯·阿贺斯图普
徐文光	徐克
徐老怪	徐克
老爷	徐克
小田刚一	高仓健
安东·巴甫洛维奇·契诃夫	契诃夫
张霹雳	张彻
老阿飞	张彻
张老湿	张彻
凡仔	廖凡
坎蒂丝·斯万内波尔	坎迪丝·斯瓦内普尔
坎蒂丝·斯瓦内普尔	坎迪丝·斯瓦内普尔
糖糖	坎迪丝·斯瓦内普尔
凯瑟琳·玛莉·海格尔	凯瑟琳·海格尔
奥兰多·布鲁	奥兰多·布鲁姆
奥兰度·布林	奥兰多·布鲁姆
开花	奥兰多·布鲁姆
奇洛·李维斯	基努·里维斯
基奴·李维	基努·里维斯
基努·李维斯	基努·里维斯
黄湛森	黄霑
黄沾	黄霑
卢笛	卢迪
为为	佟大为
丽兹·卡普兰	丽兹·卡潘
克里·费尔德曼	科里·费尔德曼
威尔·法莱尔	威尔·法瑞尔
克莱尔·安东尼娅·弗兰妮	克莱尔·弗兰妮
米洛·温缇米格丽娅	米洛·文堤米利亚
杰森·施沃茨曼	詹森·舒瓦兹曼
杰森·刘易斯	詹森·刘易斯
5角	50分
5毛	50分
克里斯·库柏	克里斯·库珀
艾迪·法柯	埃迪·法可
约翰·法兰西斯·戴利	约翰·弗朗西斯·戴利
朱丽安·休	朱莉安·浩夫
朱莉安·休	朱莉安·浩夫
蕾雅·瑟杜	蕾雅·赛杜
莱亚·西多克斯	蕾雅·赛杜
里奇·格威斯	瑞奇·热维斯
瑞奇·热尔维	瑞奇·热维斯
里奇·格维斯	瑞奇·热维斯
薇妮莎萧	凡妮莎·肖
雅丽西亚歌兰逊	艾丽西亚·格兰逊
迈克尔·霍思曼	米契尔·哈思曼
迈克尔·彗思曼	米契尔·哈思曼
费欧娜·肖	费奥纳·肖
泰森	迈克·泰森
拳王泰森	迈克·泰森
卡米尔·格瓦媞	卡蜜尔·古阿蒂
卡蜜尔·格瓦媞	卡蜜尔·古阿蒂
班尼狄·甘巴贝治	本尼迪克特·康伯巴奇
班奈狄克·康柏拜区	本尼迪克特·康伯巴奇
卷福	本尼迪克特·康伯巴奇
缺爷	本尼迪克特·康伯巴奇
塔哈尔·拉伊姆	塔哈·拉希姆
阿瑞杰·布里基斯	阿里加·巴利吉斯
特拉维斯·费美尔	崔维斯·费米尔
埃布尔·费拉拉	阿贝尔·费拉拉
亚努斯·卡明斯基	雅努什·卡明斯基
贾努兹·卡明斯基	雅努什·卡明斯基
米凯尔·哈佛斯特朗姆	米凯尔·哈弗斯特罗姆
凯瑞·弗库纳加	凯瑞·福永
福永丞次	凯瑞·福永
瓦雷·菲斯特	沃利·菲斯特
禾利·费斯达	沃利·菲斯特
禾利·费士打	沃利·菲斯特
瓦利·费思特	沃利·菲斯特
格雷格·赛斯特罗	格雷戈·赛斯特罗
格雷戈·稀赛罗	格雷戈·赛斯特罗
岩城正刚	椎名桔平
李敏浩	李敏镐
李民浩	李敏镐
小齐	任贤齐
任賢齊	任贤齐
加斯帕·帕科宁	加斯帕·帕科农
安迪·基利特	安迪·吉雷
安迪·吉列特	安迪·吉雷
永瀬正敏	永濑正敏
克里斯提诺·波顿	克里斯蒂亚诺·博尔托内
埃迪·雷德梅因	埃迪·雷德梅恩
埃迪·雷德梅尼	埃迪·雷德梅恩
艾迪·瑞德曼	埃迪·雷德梅恩
艾迪·烈美	埃迪·雷德梅恩
小雀斑	埃迪·雷德梅恩
加利·奥文	加里·奥德曼
盖瑞·欧德曼	加里·奥德曼
加里·奥尔德曼	加里·奥德曼
加里·莱昂那德·奥德曼	加里·奥德曼
狗爹	加里·奥德曼
晓治·积曼	休·杰克曼
狼叔	休·杰克曼
布斯·韦利士	布鲁斯·威利斯
布鲁斯·威利	布鲁斯·威利斯
祖狄·罗	裘德·洛
朱迪·劳	裘德·洛
孙太英	孙泰英
孙泰瑛	孙泰英
斯蒂芬·朗	史蒂芬·朗
威廉姆·达福	威廉·达福
大卫史派德	大卫·斯佩德
文森特·诺费奥	文森特·多诺费奥
弗兰西斯·麦克多门	弗兰西斯·麦克多蒙德
弗朗西丝·麦克道曼	弗兰西斯·麦克多蒙德
艾哲安·桂尼亚	艾德里安·格尼尔
艾德恩·葛尼尔	艾德里安·格尼尔
阿德里安·格兰尼	艾德里安·格尼尔
凯西·贝兹	凯西·贝茨
约翰·雷吉扎默、约翰·里古查默	约翰·雷吉扎莫
斯蒂芬·R·麦奎因	史蒂夫·R·麦奎因
桑德拉·欧	吴珊卓
安吉利卡·休斯顿	安杰丽卡·休斯顿
罗伯特-内珀	罗伯特·克耐普
杰弗瑞·坦伯	杰弗里·塔伯
契威特尔·艾吉弗	切瓦特·埃加福特
奇维托·艾吉佛	切瓦特·埃加福特
哈利·迪恩·斯坦顿	哈利·戴恩·斯坦通
艾曼妞薛納	艾玛纽尔·塞尼耶
爱莎·帕塔基	埃尔莎·帕塔奇
考特尼·拉芙	科特妮·洛芙
寇特尼·洛芙	科特妮·洛芙
祖尔艾哲顿（港译）	乔尔·埃哲顿
普里扬卡·彻普拉	佩丽冉卡·曹帕拉
朴雅卡·乔普拉	佩丽冉卡·曹帕拉
普里扬卡·乔普拉	佩丽冉卡·曹帕拉
霍尔迪·莫利亚	詹迪·莫拉
雅克·贝林	雅克·贝汉
贾克·贝林	雅克·贝汉
艾瑟夫·伯恩斯坦	阿萨夫·伯恩斯坦
观音娜	官恩娜
官Under	官恩娜
陈品颖	关颖
甜圭（昵称）	田中圭
大史可	史可
小文	文章
晓晓	杨丽晓
丽晓	杨丽晓
方瑋	方育平
马伊俐	马伊琍
马司令	马伊琍
洪秀雅	洪秀儿
袁莉	袁立
沈德鸿	茅盾
拉塞尔·马尔卡希	拉塞尔·穆卡希
拉塞尔·莫克利	拉塞尔·穆卡希
白赖仁迪庞马	布莱恩·德·帕尔玛
布莱恩狄帕玛	布莱恩·德·帕尔玛
布赖恩·德·帕尔马	布莱恩·德·帕尔玛
布莱恩·德帕玛	布莱恩·德·帕尔玛
布莱恩·德帕尔玛	布莱恩·德·帕尔玛
布赖恩·德帕尔马	布莱恩·德·帕尔玛
乔纳森·雷·麦耶斯	乔纳森·莱斯·梅耶斯
乔纳森·莱斯·迈勒斯	乔纳森·莱斯·梅耶斯
乔纳森·迈克尔·弗朗西斯·奥基夫	乔纳森·莱斯·梅耶斯
小乔	乔纳森·莱斯·梅耶斯
云露娜·维达	薇诺娜·瑞德
维诺娜·赖德	薇诺娜·瑞德
薇诺娜·劳拉·霍洛威兹	薇诺娜·瑞德
薇诺娜·赖德	薇诺娜·瑞德
艾伦·佩姬	艾伦·佩吉
爱伦·佩基	艾伦·佩吉
艾莲·佩奇	艾伦·佩吉
莱恩·高斯林	瑞恩·高斯林
高司令	瑞恩·高斯林
赖恩·高斯宁	瑞恩·高斯林
雷恩·葛斯林	瑞恩·高斯林
尤恩·迈克格雷格	伊万·麦克格雷格
伊云·麦葵格	伊万·麦克格雷格
伊万·麦格雷戈	伊万·麦克格雷格
伊万·麦奎格	伊万·麦克格雷格
尤恩·麦克格雷格	伊万·麦克格雷格
姬丝汀·史超域	克里斯汀·斯图尔特
克莉丝汀·史都华	克里斯汀·斯图尔特
克莉丝汀·斯图尔特	克里斯汀·斯图尔特
歌神	张学友
学友	张学友
七仔	张学友
友友	张学友
阿部chan	阿部宽
卡夫卡	弗兰茨·卡夫卡
王立达	罗烈
张爱嘉	张艾嘉
北村康	北村一辉
潇洒哥	张耀扬
梁乐华	岳华
孙祥钟	秦汉
康凯	秦汉
孙戈	秦汉
姜伟年	姜大卫
高内庆子	松坂庆子
布莱德利·古柏	布莱德利·库珀
毕列·谷巴	布莱德利·库珀
大软糖	杰森·席格尔
马修叔叔	杰森·席格尔
瓦尔·基尔默	方·基默
妮娜·多布雷夫	妮娜·杜波夫
杰瑞德·约瑟夫·莱托	杰瑞德·莱托
贾德·莱托	杰瑞德·莱托
谢拉·力图	杰瑞德·莱托
吉瑞米·伦奈	杰瑞米·雷纳
谢诺美·维纳	杰瑞米·雷纳
达科塔·芬宁	达科塔·范宁
达柯塔·芬妮	达科塔·范宁
汉娜·达科塔·范宁	达科塔·范宁
安娜·姬妲妮	安娜·肯德里克
派翠西娅·戴维斯·克拉克森	派翠西娅·克拉克森
小古巴·古丁	小库珀·古丁
小古巴·戈丁	小库珀·古丁
朱莉·理查德森	乔莉·理查德森
努米·拉佩斯	劳米·拉佩斯
纳奥米·劳恩	劳米·拉佩斯
劳米·拉帕斯	劳米·拉佩斯
玛姬·史密斯	玛吉·史密斯
本名：Scott L. Diggs	泰雅·迪格斯
艾美莉·华逊	艾米丽·沃森
肖恩·哈特西	肖恩·海托西
西席·斯贝西克	茜茜·斯派塞克
茜茜·斯贝西克	茜茜·斯派塞克
希希·斯派斯克	茜茜·斯派塞克
茜茜·斯派克	茜茜·斯派塞克
茜絲史柏錫	茜茜·斯派塞克
乔恩·沃伊特	强·沃特
安洁·塔如	安婕·特拉乌
谢勒·狄柏度	热拉尔·德帕迪约
杰拉尔·德帕迪约	热拉尔·德帕迪约
杰哈德尼狄厄	热拉尔·德帕迪约
猫王	埃尔维斯·普雷斯利
艾尔维斯·普雷斯利	埃尔维斯·普雷斯利
阿马瑞·诺拉斯克	阿莫里·诺拉斯科
索菲·奥康尼多	苏菲·奥康内多
迭戈·鲁纳	迭戈·卢纳
亚美丽卡·欧里沃	阿美莉嘉·奥利沃
莱昂·维埃拉	蕾奥娜·维埃拉
坦穆拉·莫里森	特穆拉·莫里森
安迪·沃卓斯基	莉莉·沃卓斯基
安迪·华卓斯基	莉莉·沃卓斯基
安迪·华高斯基	莉莉·沃卓斯基
安迪·华卓斯基	莉莉·沃卓斯基
安迪·瓦霍夫斯基	莉莉·沃卓斯基
罗伯特·席汉	罗伯特·席安
罗伯特·希恩	罗伯特·席安
卷毛	罗伯特·席安
贱卷	罗伯特·席安
罗伯特·斯沃兹曼	罗伯特·舒瓦兹曼
冈正伟	丘增
奥利维耶·马蒂内	奥利维埃·马丁内斯
费莉西蒂·琼斯	菲丽希缇·琼斯
泰勒·哈克福德	泰勒·海克福德
妮雪儿·尼柯斯	尼切尔·尼克斯
法蘭·華許	弗兰·威尔士
弗兰·沃尔什	弗兰·威尔士
法兰·沃什	弗兰·威尔士
菊地百合子	菊地凛子
赛金花（网友昵称）	塞斯·梅耶斯
李憨脑	雷·沃纳尔
屎宝	雷·沃纳尔
八月君 八月	奥古斯特·迪赫
纳森·甘宝	内森·甘宝
詹姆斯·福利	詹姆斯·弗雷
马克斯·里梅尔特	马克思·雷迈特
约翰·勒珍德	约翰·传奇
约翰·莱甄德	约翰·传奇
约翰·莱根德	约翰·传奇
德怀特·H·利特尔	德怀特·H·里特
施维·泰丝特	西尔维·泰斯蒂
马克怀伦斯	马克·里朗斯
孙言珍	孙艺珍
孙艺真	孙艺珍
卢燕卿	卢燕
卢燕春	卢燕
拉迪亚德·吉卜林	拉迪亚德·吉普林
究极美男	玉木宏
千秋王子	玉木宏
玉木大人	玉木宏
玉爷	玉木宏
宏爷	玉木宏
廖洋震	言承旭
文索怡	尹素怡
波尔·福莱	皮尔·弗莱
飞哥	俞飞鸿
金真亚	金镇雅
达米安·沙泽勒	达米恩·查泽雷
达明·舍泽尔	达米恩·查泽雷
松岡昌宏	松冈昌宏
孔林	孔琳
吴俊霖	伍佰
柿原彻也	柿原彻也
关至靓	关智斌
华哥	霍建华
睫毛帝	霍建华
白豆腐	霍建华
霍霍	霍建华
霍小呆	霍建华
草蜢	蔡一智
篮球皇帝	勒布朗·詹姆斯
小皇帝	勒布朗·詹姆斯
乔什·杜哈梅尔	乔什·杜哈明
伊安·索莫赫德	伊恩·萨默海尔德
伊安·桑默汉尔德	伊恩·萨默海尔德
伊恩·约瑟夫·萨默海尔德	伊恩·萨默海尔德
张静	张静初
桑总	托马斯·布罗迪-桑斯特
奇云·高士拿	凯文·科斯特纳
凯文·科斯纳	凯文·科斯特纳
凯文·米高·科斯特纳	凯文·科斯特纳
拉塞尔·克劳	罗素·克劳
罗素·艾拉·克劳	罗素·克劳
妮奥米·瓦兹	娜奥米·沃茨
娜奥美·屈丝	娜奥米·沃茨
诺米·瓦茨	娜奥米·沃茨
茱丽叶·庇洛仙	朱丽叶·比诺什
茱丽叶·毕诺许	朱丽叶·比诺什
海伦娜·邦汉·卡特	海伦娜·伯翰·卡特
海伦娜·伯明翰姆·卡特	海伦娜·伯翰·卡特
海伦娜·博纳姆·卡特	海伦娜·伯翰·卡特
海伦娜·宝咸·卡达	海伦娜·伯翰·卡特
罗拔唐尼	小罗伯特·唐尼
小劳勃·道尼	小罗伯特·唐尼
达叔	吴孟达
林根宝	林正英
大島由加里	大岛由加利
李孋珍	李丽珍
鄒文懷	邹文怀
软天师	葛民辉
阿鼻	葛民辉
郑旦瑞	郑丹瑞
何佩勤	陈宝珠
车沅沅	车婉婉
沈岳焕	沈从文
休芸芸	沈从文
甲辰	沈从文
上官碧	沈从文
璇若	沈从文
查琳·依	查琳·易
易筱凌	查琳·易
隐士	韦家辉
露絲克兒（港）	露西·海尔
克里斯多佛·罗伯特·埃文斯	克里斯·埃文斯
克里斯·伊文斯	克里斯·埃文斯
基斯·伊雲斯	克里斯·埃文斯
克里斯·伊凡	克里斯·埃文斯
阿龙·约翰逊	亚伦·泰勒-约翰逊
艾伦·约翰逊	亚伦·泰勒-约翰逊
亚伦·强森	亚伦·泰勒-约翰逊
亚伦·约翰逊	亚伦·泰勒-约翰逊
保罗·吉亚马提	保罗·吉亚玛提
迈克·梅尔斯	麦克·梅尔斯
史小芳（网友昵称）	比尔·哈德尔
贾斯汀·朗恩	贾斯汀·朗
约翰·C·瑞利	约翰·C·赖利
莫瑞娜·巴卡琳	莫蕾娜·巴卡林
吉娜·吉舍恩	吉娜·格申
朱丽叶·刘易斯	朱丽叶特·刘易斯
杰森·艾萨克斯	詹森·艾萨克
史戴伦史柯斯嘉	斯特兰·斯卡斯加德
斯特兰·萨森加德	斯特兰·斯卡斯加德
凯莉·普雷斯顿	卡丽·普雷斯顿
罗宾·滕尼	罗宾·汤尼
贾森·帕特里克	杰森·帕特里克
安纳·贝宁	安妮特·贝宁
克里斯·普拉特	克里斯·帕拉特
星爵	克里斯·帕拉特
帕帕	克里斯·帕拉特
哈维·菲尔斯坦	哈维·费斯特恩
阿伦·索尔金	艾伦·索金
阿伦·本杰明·索尔金	艾伦·索金
尼克·卡索维茨	尼克·卡萨维茨
尼克·卡萨维兹	尼克·卡萨维茨
戴兰兰	戴夫·弗兰科
亚历山德拉·托瑞萨妮	亚历山德拉·托蕊桑尼
迪亚布罗·科蒂	迪亚波罗·科蒂
莱塞·霍尔斯道姆	拉斯·霍尔斯道姆
贾斯汀·钱	全知泰
全智泰	全知泰
乔丹·汉森	乔丹·莘森
朱莉·哈格蒂	朱丽·哈基提
狄米崔·马丁	迪米特利·马丁
约翰·欧蒂斯	约翰·奥提兹
马克·撒罗	马克·扎罗
肯伊·威斯特	坎耶·威斯特
乔舒亚·列奥纳德	乔舒华·莱纳德
娜奥美·金宝	娜奥米·坎贝尔
雅梅尔·德布兹	贾梅尔·杜布兹
加梅勒·杜布兹	贾梅尔·杜布兹
唐纳德·川普	唐纳德·特朗普
邓川普	唐纳德·特朗普
唐川普	唐纳德·特朗普
李贤均	在熙
彭妮露比·韋頓	佩内洛普·威尔顿
让·杜雅丁	让·杜雅尔丹
让·杜雅赫丹	让·杜雅尔丹
答案	阿伦·艾弗森
戳爷	特洛耶·希文
赖瑞·麦可莫特瑞	拉里·麦克穆特瑞
维罗尼卡·费里斯	维罗尼卡·费瑞尔
米乔·赞布罗斯基	米哈乌·热布罗夫斯基
黑木明纱	黑木美沙
黑木梅纱	黑木美沙
長澤正美	长泽雅美
麻酱	长泽雅美
安齐智子	伊东美咲
陈宝玲	陈宝莲
于佩文	于蓝
李·佩思	李·佩斯
凯特·邓宁思	凯特·戴琳斯
凯瑟琳·李特维克	凯特·戴琳斯
凯特·丹宁丝	凯特·戴琳斯
克洛伊·莫雷茨	科洛·莫瑞兹
克萝伊·葛蕾丝·莫瑞兹	科洛·莫瑞兹
科洛·格蕾斯·莫瑞兹	科洛·莫瑞兹
基斯比·汤纳度	朱塞佩·托纳多雷
吉斯皮托那多利	朱塞佩·托纳多雷
朱塞佩·托纳托雷	朱塞佩·托纳多雷
吉赛贝·托纳多雷	朱塞佩·托纳多雷
格温妮丝·帕特洛	格温妮斯·帕特洛
格温妮斯·帕特罗	格温妮斯·帕特洛
希拉蕊·朵芙	希拉里·达芙
林赛·罗韩	琳赛·洛翰
林赛·洛韩	琳赛·洛翰
琳赛·罗汉	琳赛·洛翰
林赛·罗韩	琳赛·洛翰
琳赛·露安	琳赛·洛翰
蕾切尔·薇姿	蕾切尔·薇兹
丽舍·薇兹	蕾切尔·薇兹
瑞秋·怀兹	蕾切尔·薇兹
瑞秋·薇兹	蕾切尔·薇兹
查丽兹·赛隆	查理兹·塞隆
查理斯·塞隆	查理兹·塞隆
莎莉‧賽隆	查理兹·塞隆
詹姆斯·弗兰克	詹姆斯·弗兰科
詹姆斯·弗朗哥	詹姆斯·弗兰科
詹姆斯·佛朗戈	詹姆斯·弗兰科
詹姆斯法兰科	詹姆斯·弗兰科
付兰兰	詹姆斯·弗兰科
弗兰兰	詹姆斯·弗兰科
彼特·丁克拉奇	彼特·丁拉基
彼得·汀克莱杰	彼特·丁拉基
彼得·丁克拉格	彼特·丁拉基
约翰·周	约翰·赵
约翰·乔	约翰·赵
赵耀翰	约翰·赵
学长	约翰·赵
囧秋	约翰·赵
梅尔康·麦德威	马尔科姆·麦克道威尔
罗恩·列文斯顿	朗·里维斯顿
泰瑞·波罗	特莉·保罗
可琳坎普	考林·加普
威尔佛瑞迪（台）	威尔·福特
樊尚·佩雷	文森特·佩雷斯
文森特·佩雷	文森特·佩雷斯
文森·佩雷兹	文森特·佩雷斯
伊莎贝拉·罗塞里尼	伊莎贝拉·罗西里尼
约尔根·普罗赫诺	尤尔根·普洛斯诺
葛瑞芬·杜恩	格里芬·邓恩
丹尼斯·海斯伯	丹尼斯·海斯伯特
丹尼斯·希士毕	丹尼斯·海斯伯特
斯蒂芬·托博洛斯基	斯蒂芬·托布罗斯基
布鲁斯·德恩	布鲁斯·邓恩
史巴斯甸高治	塞巴斯蒂安·科赫
塞巴斯蒂安·考奇	塞巴斯蒂安·科赫
阿瑟·柯南道尔	阿瑟·柯南·道尔
阿瑟·伊格納修斯·柯南·道尔爵士	阿瑟·柯南·道尔
樱13	樱井孝宏
考哥	樱井孝宏
肥Kent	郑则仕
Kent哥	郑则仕
肥猫	郑则仕
郑则士	郑则仕
應采兒	应采儿
祖祖	容祖儿
查良镛	金庸
林欢	金庸
萧瑶	王宇婕
菲利普·弥勒	费利普·弥勒
菲利普·穆伊尔	费利普·弥勒
黄欣	黄建新
林志峰	林强
叶甫盖尼·斯蒂奇金	叶夫根尼·斯迪查金
吴军	吴军忱
蒋文丽	蒋雯丽
杨张新悦	张燊悦
张伟新	张伟欣
谢元	谢园
谢洪坤	谢添
谢俊	谢添
锤哥	克里斯·海姆斯沃斯
基斯·咸士禾夫	克里斯·海姆斯沃斯
海总	克里斯·海姆斯沃斯
384（昵称）	塞巴斯蒂安·斯坦
美誉：花蝴蝶	玛丽亚·凯莉
姬丝汀·史葛·汤玛丝	克里斯汀·斯科特·托马斯
克莉丝汀·史考特·汤玛斯	克里斯汀·斯科特·托马斯
克莉斯汀·史考特·汤玛士	克里斯汀·斯科特·托马斯
艾米·罗森	埃米·罗森
姜小军	姜文
西亚·李毕福	希亚·拉博夫
希安·拉博夫	希亚·拉博夫
珊迪娜·布洛	桑德拉·布洛克
西尔沙·罗南	西尔莎·罗南
斯奥里兹·罗南	西尔莎·罗南
斯奥莎·罗南	西尔莎·罗南
塞奥斯·罗南	西尔莎·罗南
罗丝·伯恩	萝丝·拜恩
罗斯·波恩	萝丝·拜恩
伊莉莎贝·莫斯	伊丽莎白·莫斯
玛莉.露丝.柏嘉（港）	玛丽·露易斯·帕克
伊冯娜·斯特泽丘斯基	伊冯娜·斯特拉霍夫斯基
冯妮-斯特泽柯维斯基	伊冯娜·斯特拉霍夫斯基
西蒙·贝克尔	西蒙·贝克
馒头叔	西蒙·贝克
凯西·阿弗莱克	卡西·阿弗莱克
史蒂文·马丁 斯蒂夫·马丁	史蒂夫·马丁
克里斯汀·史莱特	克里斯蒂安·史莱特
山姆·埃利奥特	山姆·艾里奥特
珍妮佛·劳伦斯	詹妮弗·劳伦斯
珍妮弗·劳伦斯	詹妮弗·劳伦斯
大表姐	詹妮弗·劳伦斯
安猪	安德鲁·加菲尔德
加菲	安德鲁·加菲尔德
戴伦·斯普拉尔斯	迪伦·斯普罗斯
迪兰·斯普拉尔斯	迪伦·斯普罗斯
迪伦·斯普拉尔斯	迪伦·斯普罗斯
吉莉安·安德森	吉莲·安德森
瑪丹娜（台灣地區）	麦当娜
杰西卡·坎普莎	杰西卡·卡普肖
理查德·阿米塔格	理查德·阿米蒂奇
理查德·阿莫蒂奇	理查德·阿米蒂奇
理察·阿米塔格	理查德·阿米蒂奇
李建军	理查德·阿米蒂奇
大舅	理查德·阿米蒂奇
格雷塔·盖尔维格	格蕾塔·葛韦格
格里塔·格文格	格蕾塔·葛韦格
格蕾塔·格维希	格蕾塔·葛韦格
黛伯拉·麦辛	黛博拉·梅辛
梅根·朴	梅根·帕克
克里斯托弗·戈洛姆	克里斯托弗·戈勒姆
克里斯托弗·高哈姆	克里斯托弗·戈勒姆
维欧拉·戴维斯	维奥拉·戴维斯
薇奥拉·戴维斯	维奥拉·戴维斯
维奥拉·戴维斯	维奥拉·戴维斯
尼基·苏胡	司徒少英
妮基·苏弗	司徒少英
贾辛达·巴雷特	杰茜达·芭瑞特
科尔姆·费奥瑞	科鲁姆·费奥瑞
强德特杜巴	乔·德特杜巴
乔恩·图泰尔泰博	乔·德特杜巴
奥巴马	巴拉克·奥巴马
欧巴马	巴拉克·奥巴马
史迪格·拉森	斯蒂格·拉赫松
梁凯蒂	梁佩诗
艾瑞克·斯兹曼达	艾瑞克·兹曼达
艾里克·斯曼达	艾瑞克·兹曼达
大卫·欧·拉塞尔	大卫·O·拉塞尔
大卫·欧拉塞尔	大卫·O·拉塞尔
戴维O·拉塞尔	大卫·O·拉塞尔
大卫·罗素	大卫·O·拉塞尔
道格·利曼	道格·里曼
劳尔·博瓦	雷欧·波瓦
彼得·波格丹诺维奇	彼得·博格丹诺维奇
毕迪高拔	布拉迪·科贝特
积奥干奴	杰克·奥康奈尔
詹妮弗·芬尼甘	詹妮佛·芬尼甘
乔安妮·凯瑟琳·罗琳	J·K·罗琳
四妹	比尔·斯卡斯加德
倪星	邹兆龙
泽尔妲·威廉姆斯	泽尔妲·威廉斯
塞尔达·威廉姆斯	泽尔妲·威廉斯
赛门·金伯格	西蒙·金伯格
盖·巴内特	盖·布耐特
陈皑鸽	陈凯歌
乔斯·帕迪哈	何塞·帕迪里亚
若泽·帕迪利亚	何塞·帕迪里亚
若泽·帕迪里亚	何塞·帕迪里亚
冯进财	冯德伦
阿咪	郑秀文
郑四万	郑秀文
周镇模	朱镇模
周真摹	朱镇模
千成林	宋智孝
宋知孝	宋智孝
千秀妍	宋智孝
陈医生	陈奕迅
李慧娴	李若彤
许真浩	许秦豪
温碧玉	温碧霞
麦嘉琪	麦家琪
麦方乔	麦家琪
田中千繪	田中千绘
石岚	石兰
邝毅怡	王喜
阿喜	王喜
韩宰硕	韩在硕
韩载锡	韩在硕
韩宰锡	韩在硕
韩在石	韩在硕
韩载硕	韩在硕
马修·博曼	马特·波莫
马特·波莫	马特·波莫
孔雀	马特·波莫
菲达萍杜	芙蕾达·平托
芙蕾达·赛琳娜·平托	芙蕾达·平托
杰夫·戈德布拉姆	杰夫·高布伦
杰夫·古德布鲁姆	杰夫·高布伦
杰弗里·林恩·戈德布拉姆	杰夫·高布伦
杰夫·戈德布罗姆	杰夫·高布伦
艾尔·范宁	艾丽·范宁
米娅·华西科沃斯卡	米娅·华希科沃斯卡
米娅·沃斯科斯卡	米娅·华希科沃斯卡
米雅·瓦斯科斯卡	米娅·华希科沃斯卡
马修·麦克菲迪恩	马修·麦克费登
凯瑞·茉莉简	凯瑞·穆里根
凯芮·穆里根	凯瑞·穆里根
凯莉·穆里根	凯瑞·穆里根
凯瑞·穆利甘	凯瑞·穆里根
凯瑞·穆丽根	凯瑞·穆里根
李阳中	李连杰
佳夫•奧雲	克里夫·欧文
基利夫•奧雲	克里夫·欧文
盖伊·里奇	盖·里奇
本·威士肖	本·卫肖
本·韦肖	本·卫肖
瓦妮莎·安妮·哈金斯	凡妮莎·哈金斯
雲妮莎夏芝絲	凡妮莎·哈金斯
戴安·克鲁格	黛安·克鲁格
戴安·古格	黛安·克鲁格
蒂尔达·斯温顿	蒂尔达·斯文顿
蒂妲史云顿	蒂尔达·斯文顿
蒂尔达·斯维顿	蒂尔达·斯文顿
艾伦·里克曼	艾伦·瑞克曼
阿伦·瑞克曼	艾伦·瑞克曼
阿兰·瑞克曼	艾伦·瑞克曼
阿伦·烈卡文	艾伦·瑞克曼
蜜拉·乔娃薇琪	米拉·乔沃维奇
蒂姆·罗思	蒂姆·罗斯
添羅夫	蒂姆·罗斯
尚·连奴	让·雷诺
瑪雅·露多芙	玛娅·鲁道夫
绿草地	保罗·格林格拉斯
加斯丁·特奥克斯	贾斯汀·塞洛克斯
贾斯汀·瑟鲁	贾斯汀·塞洛克斯
比利·鲍伯·斯顿	比利·鲍伯·松顿
比利·鲍·科顿	比利·鲍伯·松顿
比利·鲍伯·桑顿	比利·鲍伯·松顿
蒂莫西·哈顿	蒂莫西·赫顿
彼得·库伦	彼特·库伦
马丁·多诺文	马丁·唐文
杰拉尔丁·卓别林	杰拉丁·卓别林
裘拉汀·卓别林	杰拉丁·卓别林
约翰·赫斯顿	约翰·休斯顿
乔纳森·西佛尔曼	乔纳森·斯沃曼
贾恩卡洛·詹尼尼	吉安卡罗·吉安尼尼
霍华德·菲利普·洛夫克拉夫特	H·P·洛夫克拉夫特
H.P.勒福克拉褔	H·P·洛夫克拉夫特
朱利安·费洛斯	朱利安·费罗斯
乌尔里希·图克尔	乌尔里希·图库尔
马文·范·皮布尔斯	马文·范·皮伯斯
雷·布拉德百利	雷·布莱德伯里
提奥·凡·高	提奥·凡高
大仲马	亚历山大·仲马
谭富荣	狄龙
卡蒂·欧蒂宁	卡蒂·奥廷宁
谷德超	谷德昭
四哥	谢贤
谢家钰	谢贤
扎克·加利费安纳基斯	扎克·加利凡纳基斯
杰斯·艾森伯格	杰西·艾森伯格
尚-克劳德·范·戴姆	尚格·云顿
尚-格·云·顿	尚格·云顿
萨姆·莱米	山姆·雷米
萨查·巴隆·科恩	萨莎·拜伦·科恩
沙格·畢朗·高漢	萨莎·拜伦·科恩
沙夏·拜倫·科恩	萨莎·拜伦·科恩
强·费儒	乔恩·费儒
切维依·蔡斯	切维·切斯
安杰拉·兰斯伯里	安吉拉·兰斯伯瑞
多明尼克威斯特	多米尼克·威斯特
布莱恩纳·伊维根	布莱恩娜·伊维根
鲁伯特·福兰德	鲁伯特·弗兰德
渡辺謙	渡边谦
吉列尔莫·德尔·托罗	吉尔莫·德尔·托罗
葛雷摩·戴托罗	吉尔莫·德尔·托罗
乔勒蒙·迪多罗	吉尔莫·德尔·托罗
陀螺	吉尔莫·德尔·托罗
布瑞·拉尔森	布丽·拉尔森
亚瑟小子	亚瑟·雷蒙德
马修·约瑟夫·达拉斯	马特·达拉斯
凤凰	马特·达拉斯
小凤凰	马特·达拉斯
安东尼·麦肯	安东尼·麦凯
安东尼·马奇	安东尼·麦凯
安东尼·麦基	安东尼·麦凯
帕明德·纳格拉	帕敏德·纳格拉
马克斯·泰瑞奥	麦克斯·泰瑞奥
马克斯·塞奥特	麦克斯·泰瑞奥
麦斯·塞瑞特	麦克斯·泰瑞奥
马克思·席瑞特	麦克斯·泰瑞奥
马克斯·希尔莱耶	麦克斯·泰瑞奥
比尔·康登	比尔·康顿
基勒·桑切斯	基拉·桑切斯
米罗娜·沃尔特斯	梅罗拉·沃特斯
罗布·马歇尔	罗伯·马歇尔
凯尔·吉尔克瑞斯特	凯尔·吉克瑞斯特
凯尔·吉尔奎斯特	凯尔·吉克瑞斯特
达妹、达达	达科塔·约翰逊
托米·韦斯奥	托米·韦素
汤米·韦索	托米·韦素
汤米·威叟	托米·韦素
汤米·威索	托米·韦素
福利	弗利
迈克尔·克里彻顿	迈克尔·克莱顿
马克·兰度	马克·兰道尔
克里司汀·库尔森	克里斯蒂安·库尔森
艾仁·克鲁格	伊伦·克鲁格
熊熊	熊黛林
阿Lynn	熊黛林
阿祖	吴彦祖
蛋妞	吴彦祖
吴老板	吴彦祖
米卡埃尔·佩尔斯勃兰特	米卡埃尔·佩斯布兰特
米克尔·佩斯勃兰特	米卡埃尔·佩斯布兰特
偶尔鸣叫的丹丹龙	丹·史蒂文斯
丹丹龙	丹·史蒂文斯
大表哥	丹·史蒂文斯
古仔	古天乐
古古	古天乐
珊珊	徐熙媛
大S	徐熙媛
璐璐宝贝	李小璐
比丝多丽丝候活	布莱丝·达拉斯·霍华德
玛吉·格莱恩哈尔	玛吉·吉伦哈尔
麦琪·吉伦哈尔	玛吉·吉伦哈尔
麦琪·盖伦哈尔	玛吉·吉伦哈尔
美姬佳伦荷	玛吉·吉伦哈尔
米高比尔	迈克尔·贝
麦可贝	迈克尔·贝
周米卡	周迅
迅儿	周迅
迅哥	周迅
小迅	周迅
周公子	周迅
老周	周迅
迅姐	周迅
詹姆斯·卡维泽	吉姆·卡维泽
马克·汉米尔	马克·哈米尔
大卫·鲍迪奇·莫尔斯	大卫·摩斯
弗兰·德雷彻尔	法兰·德瑞雪
法兰·卓雪	法兰·德瑞雪
琳达·汉弥尔顿	琳达·汉密尔顿
托尼·谢尔博	托尼·夏尔赫布
尼芙·坎贝尔	内芙·坎贝尔
娜维·坎蓓尔	内芙·坎贝尔
塔特·唐诺万	泰特·多诺万
真田広之	真田广之
尼杰达·米嘉可夫	尼基塔·米哈尔科夫
尼基塔·米亥科夫	尼基塔·米哈尔科夫
给给	马克·加蒂斯
麦哥	马克·加蒂斯
艾尔萨·兹尔贝斯坦	艾尔莎·泽贝斯坦
埃丽莎兹伯斯坦	艾尔莎·泽贝斯坦
蒂姆·赫利希	提姆·赫利希
关家慧	关之琳
关芝琳	关之琳
十三姨	关之琳
熊猫	山田孝之
黎珈而	黎姿
荔枝	黎姿
愛美神	黎姿
皮埃尔·肖戴洛·德拉克洛	拉克洛
吴吉尊	吴尊
罗恩·奈斯瓦纳	罗恩·内斯万尼尔
宋承福	宋承宪
金亚中	金雅中
伊知地昭子	黑木瞳
欣欣	邓丽欣
李璨琛	李灿森
李伟聪	李灿森
李灿琛	李灿森
小旋风	林志颖
小志	林志颖
郑俊浩	郑俊镐
时尚达人	吴佩慈
九头身怪怪美少女	吴佩慈
女人汤团（绰号）	汤镇业
王傑	王杰
王大为	王杰
王大伟	王杰
坤玄	黄坤玄
万二蚊	万绮雯
安仔	郭晋安
安安	郭晋安
朴相民	朴尚民
付彪	傅彪
朴和善	朴河宣
朴夏善	朴河宣
朴河善	朴河宣
朴荷善	朴河宣
胡静凡	胡靖钒
刘伯瑶	刘琼
周树人	鲁迅
周樟寿	鲁迅
周豫山	鲁迅
周豫才	鲁迅
凯丽	张凯丽
凯莉	张凯丽
赵平复	柔石
蕾安娜	蕾哈娜
任達華	任达华
华哥	任达华
杰里米·艾恩斯	杰瑞米·艾恩斯
谢洛美艾朗斯	杰瑞米·艾恩斯
杰勒米·艾恩斯	杰瑞米·艾恩斯
杰瑞米‧艾朗	杰瑞米·艾恩斯
铁叔	杰瑞米·艾恩斯
瑞斯·威瑟斯彭	瑞茜·威瑟斯彭
莉丝韦花斯本	瑞茜·威瑟斯彭
瑞西维丝彭	瑞茜·威瑟斯彭
瑞丝薇斯朋	瑞茜·威瑟斯彭
皮雅斯·布士南	皮尔斯·布鲁斯南
皮尔斯·布洛斯南	皮尔斯·布鲁斯南
里安纳逊	连姆·尼森
连恩尼逊	连姆·尼森
利亚姆·尼森	连姆·尼森
连恩·尼森	连姆·尼森
乌玛·舒曼	乌玛·瑟曼
茱迪科士打	朱迪·福斯特
茱迪·福斯特	朱迪·福斯特
科林·费斯	科林·费尔斯
柯林·菲尔斯	科林·费尔斯
柯林·费尔斯	科林·费尔斯
科林·菲尔什	科林·费尔斯
科林·弗思	科林·费尔斯
脸叔	科林·费尔斯
钱宁·塔图姆	查宁·塔图姆
查宁泰坦	查宁·塔图姆
查尼塔图	查宁·塔图姆
保罗获加	保罗·沃克
克里斯腾·贝尔	克里斯汀·贝尔
魏世聿	魏骏杰
张瀚	张翰
艾莉西亚席维史东	艾丽西亚·希尔维斯通
伊面	郑伊健
奥利维亚·维尔德	奥利维亚·王尔德
科尔蓝·鲁兹	凯南·鲁兹
Kate Rooney Mara（本名）	凯特·玛拉
莎拉·布姬	索拉·伯奇
索拉·布奇	索拉·伯奇
白叔	布莱恩·科兰斯顿
老白	布莱恩·科兰斯顿
马导	马修·格雷·古柏勒
R宝宝	马修·格雷·古柏勒
男神经	马修·格雷·古柏勒
絲娜佳萊莉（港）	西耶娜·盖尔利
寇特·罗素	库尔特·拉塞尔
拉希达·琼斯	拉什达·琼斯
强·哈姆	乔恩·哈姆
乔·哈姆	乔恩·哈姆
火腿叔	乔恩·哈姆
卓丽莎 葆玛（港）	泰莉莎·帕尔墨
霍莉·亨特	霍利·亨特
丹妮尔·哈里斯	丹妮尔·阿克斯
罗恩·霍华德	朗·霍华德
朗侯活	朗·霍华德
约翰·图图罗	约翰·特托罗
约翰·托尔托罗	约翰·特托罗
罗利·科克瑞恩	罗利·科奇瑞恩
丹尼·库克	戴恩·库克
小威廉·乔治·泽恩	比利·赞恩
提摩菲史樸	蒂莫西·斯波
洛·比桑	吕克·贝松
卢·贝松	吕克·贝松
路·比桑	吕克·贝松
比利·克里斯特尔	比利·克里斯托
扎克·斯奈德	扎克·施奈德
查克·史奈德	扎克·施奈德
柴克·史奈德	扎克·施奈德
萨拉·博劳格	莎拉·伯格
乔玛·塔昆	乔玛·塔科内
维克托·加柏	维克多·加博
埃德华·詹姆斯·奥尔	爱德华·詹姆斯·奥莫斯
保罗·W·S·安德森	保罗·安德森
姬莉·麥當奴	凯莉·麦克唐纳
彼得·伯格	彼得·博格
马克·达卡科斯	马克·达卡斯考斯
简·马奇	珍·玛奇
保罗·哈奇斯	保罗·哈吉斯
旺达·塞克丝	婉妲·塞克丝
大鲨鱼	沙奎尔·奥尼尔
菲斯·考罗	瑞斯·考罗
克里斯多弗·安东尼·约翰·马汀	克里斯·马汀
克里斯·马丁	克里斯·马汀
华金姆·德·阿尔梅达	乔昆姆·德·阿尔梅达
若阿金 德 阿尔梅达	乔昆姆·德·阿尔梅达
鞍山	安松·蒙特
弗莱德·威廉森	弗雷德·威廉森
哈维尔·多兰	泽维尔·多兰
伊泽维尔·多兰	泽维尔·多兰
札维耶·多蓝	泽维尔·多兰
王圣德	王盛德
詹姆斯·温	温子仁
拉菲·斯帕尔	拉菲·斯波
辛西娅·罗斯洛克	罗芙洛
艾德灵连	阿德里安·莱恩
安卓安林	阿德里安·莱恩
拉米·巴哈尼	拉敏·巴哈尼
拉明·巴拉尼	拉敏·巴哈尼
罗纳德·温斯顿·袁	袁文忠
罗恩·袁	袁文忠
袁隆	袁文忠
吉勒莫·亚瑞格	吉勒莫·阿里加
菲尔·奥尔登·鲁宾逊	菲尔·奥尔登·罗宾森
迈克尔·博尔顿	迈克尔·波顿
迈克尔·鲍顿	迈克尔·波顿
郑宇成	郑雨盛
郑雨圣	郑雨盛
蒂姆·斯托里	蒂姆·斯托瑞
巴尔塔萨·库马克	巴塔萨·科马库
巴尔特萨·科曼库尔	巴塔萨·科马库
杰森·福斯	贾森·福克斯
田海琳	河智苑
全海林	河智苑
河知云	河智苑
河智元	河智苑
河智媛	河智苑
夏智媛	河智苑
佛罗里昂卢卡斯	弗洛里安·卢卡斯
福尔克·布鲁赫	沃尔克·布鲁赫
盧惠光	卢惠光
克拉娜·拉高	克拉拉·拉戈
克拉拉·拉高	克拉拉·拉戈
乔汗·菲利普·阿斯巴克	皮鲁·埃斯贝克
吴青云	吴青芸
奥拉维尔·达里·奥拉弗森	奥拉维尔·达里·奥拉夫松
亨利·易卜生	易卜生
李绮红	李绮虹
迈克尔·默斯诺	迈克尔·穆索诺夫
小健	神山健治
健酱	神山健治
啃鸡	神山健治
符力	方中信
郑创世	郑少秋
阿B	钟镇涛
锺镇涛	钟镇涛
阿谭	谭耀文
塞巴斯蒂安·坎波斯	塞巴斯蒂安·莱里奥
李思思	叶童
良心君	安元洋贵
Y元	安元洋贵
饲主	安元洋贵
白姐	安琪拉.薇蒂
一线天	安琪拉.薇蒂
林园	林源
沙维尔·塞缪尔	泽维尔·塞缪尔
蜜雪儿菲佛	米歇尔·菲佛
阿历斯·彼迪化	亚历克斯·帕蒂弗
阿历克斯·派迪弗	亚历克斯·帕蒂弗
米基·鲁尔克	米基·洛克
西蒙·柏奇	西蒙·佩吉
赛门·佩吉	西蒙·佩吉
全知贤	全智贤
王智贤	全智贤
伊万·雷彻尔·伍德	埃文·蕾切尔·伍德
伊云妮素活特	埃文·蕾切尔·伍德
克莉丝蒂娜.里琪	克里斯蒂娜·里奇
姬丝汀娜·莉芝	克里斯蒂娜·里奇
奥尔加·库里连科	欧嘉·柯瑞兰寇
奥莉加·库雷连科	欧嘉·柯瑞兰寇
罗拔·柏迪臣	罗伯特·帕丁森
罗伯·派汀森	罗伯特·帕丁森
佳·皮雅斯	盖·皮尔斯
佳比亚斯	盖·皮尔斯
姬蒂·韓遜	凯特·哈德森
麦克·华保	马克·沃尔伯格
马克·华柏格	马克·沃尔伯格
申君谊	申军谊
瑞恩·科万腾	瑞恩·柯万腾
瑞恩·科万顿	瑞恩·柯万腾
凯莉·库柯-斯威汀	凯莉·库柯
卡蕾·措科	凯莉·库柯
凯莉·库科	凯莉·库柯
珍妮弗·比尔斯	詹妮弗·比尔斯
曼纽尔·克莉琪	埃曼纽尔·施莱琪
谢夫·布烈治	杰夫·布里吉斯
杰夫·布里吉	杰夫·布里吉斯
督爷	杰夫·布里吉斯
杰夫·布里奇斯	杰夫·布里吉斯
乔万尼·里比斯	吉奥瓦尼·瑞比西
乔瓦尼·瑞比西	吉奥瓦尼·瑞比西
乔凡尼·瑞比希	吉奥瓦尼·瑞比西
克里斯托弗·普拉默	克里斯托弗·普卢默
艾美·莫迪玛	艾米莉·莫迪默
占美霍士	杰米·福克斯
艾瑞克·马龙·毕夏普	杰米·福克斯
尼古拉斯·侯特	尼古拉斯·霍尔特
尼克拉斯·霍特	尼古拉斯·霍尔特
尼克拉斯·霍尔特	尼古拉斯·霍尔特
岳母大人	凯伦·吉兰
达瑞尔·汉娜	达丽尔·汉纳
西蒙·黑尔贝格	西蒙·赫尔伯格
葆拉·帕顿	宝拉·巴顿
汤姆·韦斯	汤姆·威兹
汤姆·韦茨	汤姆·威兹
迪娜·梅耶	迪娜·迈耶
蒂娜· 梅尔	迪娜·迈耶
戴安· 梅尔	迪娜·迈耶
加勒特·迪拉胡特	加瑞特·迪拉胡特
C·汤玛斯·郝威	C·托马斯·豪威尔
汤姆·西斯摩尔	汤姆·塞兹摩尔
大卫·卡拉丹	大卫·卡拉丁
蕾切尔·格里菲思	瑞切尔·格里菲斯
湯·韋堅遜	汤姆·威尔金森
蒂尔·斯威格	蒂尔·施威格
提尔·史威格	蒂尔·施威格
珍·方達	简·方达
艾伦·鲍斯汀	艾伦·伯斯汀
瑞·罗门那	雷·罗马诺
特仑苏·马立克	泰伦斯·马力克
泰伦斯马力	泰伦斯·马力克
沙拉·鲍尔森	莎拉·保罗森
香蕉姐	莎拉·保罗森
厄尼·哈德森	埃涅·赫德森
萨拉·丝沃曼	萨拉·西尔弗曼
米兰达·奥托	米兰达·奥图
丹尼尔·亨利	丹尼尔·海尼
索菲亚·蒙克	苏菲·蒙克
托尼托德	托尼·托德
陈静	嘉玛·陈
玛格丽特·赵	赵牡丹
拉加·戈斯内尔	拉加·高斯内尔
瑞恩·卡恩斯	莱安·卡勒斯
里安·约翰逊	莱恩·约翰逊
加藤小雪	小雪
松山小雪	小雪
佐藤忠信	浅野忠信
安德鲁·亚当逊	安德鲁·亚当森
约尔丁·斯巴克斯	乔丁·斯巴克斯
彼得·法拉利	彼得·法雷利
阿奇·高	高圣远
让-巴普提斯特·莫尼耶	让-巴蒂斯特·莫尼耶
尚-巴堤·莫里耶	让-巴蒂斯特·莫尼耶
里兹·阿曼德	里兹·阿迈德
冰淇淋	林志玲
杰夫·尼科尔斯	杰夫·尼克尔斯
黎生	黎明
雷金纳德·赫德林	雷吉纳·哈德林
吴志强	吴镇宇
阿海	吴镇宇
靓坤	吴镇宇
觉一居士	吴镇宇
吴妈	吴镇宇
吴三岁	吴镇宇
琼·迪第恩	琼·迪丹
狄第恩	琼·迪丹
渣渣辉	张家辉
楊麗青	杨丽菁
郑勇俊	张赫
米尔黑姆·考特兹	米尔黑·考塔兹
伦纳德·阿伯拉罕森	伦尼·阿伯拉罕森
林峰	林峯
林逸峯	林峯
林汇文	林峯
斯台芬·茨威格	斯蒂芬·茨威格
磊子	黄磊
黄小厨	黄磊
黄老师	黄磊
神算子	黄磊
老狐狸	黄磊
陈虹	陈红
梁玉燕	梁琤
梁铮	梁琤
周斯拉	周韵
江丽娜	唐宁
唐寧	唐宁
波士高、阿Co、波仔	黄宗泽
鹏哥	卢海鹏
丁嘉莉	丁嘉丽
梁志健	森美
刘庆基	刘丹
丹爷	刘丹
叉烧炳	刘丹
李京英	李璟荣
李庆荣	李璟荣
于小惠	于小慧
程浩枫	程皓枫
孙以亮	孙道临
孙大雨	孙道临
淳于山	淳于珊珊
颜炳燕	颜丙燕
谢拉·毕拿	杰拉德·巴特勒
杰哈德巴特勒	杰拉德·巴特勒
杰哈德巴狄厄	杰拉德·巴特勒
马克·鲁法洛	马克·鲁弗洛
马克·拉法罗	马克·鲁弗洛
麦克雷法路	马克·鲁弗洛
艾玛·史东	艾玛·斯通
爱玛·史东	艾玛·斯通
石头	艾玛·斯通
龙格尔	杜夫·龙格尔
道夫·龙格尔	杜夫·龙格尔
杜夫·朗格林	杜夫·龙格尔
多夫·伦德格伦	杜夫·龙格尔
杜夫·朗格	杜夫·龙格尔
马修·麦康瑞	马修·麦康纳
马修·迈康瑙希	马修·麦康纳
马修·麦康纳希	马修·麦康纳
桑迪·牛顿	坦迪·牛顿
琼·海德	乔恩·海德
丹尼·狄維圖	丹尼·德维托
史坦利·图齐	斯坦利·图齐
法姆克·詹森	法米克·詹森
芳姬·詹森	法米克·詹森
范克·简逊	法米克·詹森
法米克·楊森	法米克·詹森
彼德·积逊	彼得·杰克逊
彼得·杰克森	彼得·杰克逊
彼特·杰克逊	彼得·杰克逊
彼德·杰克逊	彼得·杰克逊
莎尔莱勒·伍德蕾	谢琳·伍德蕾
莎蓮活德麗	谢琳·伍德蕾
丽贝卡·罗梅恩-斯坦默斯	丽贝卡·罗梅恩
麦兹·米克森	麦斯·米科尔森
麦德斯·米科尔森	麦斯·米科尔森
贾斯汀·查特温	贾斯汀·查特文
克洛伊·塞维尼	科洛·塞维尼
苏菲·玛素	苏菲·玛索
姐夫	乔尔·麦克哈尔
帕特里克·福盖特	派屈克·福吉特
迪伦麦狄蒙	迪伦·麦克德莫特
迪兰·麦克德莫特	迪伦·麦克德莫特
伯·德里克	波·德瑞克
宝黛丽	波·德瑞克
贾森·斯科特·李	李截
丹妮亚·莱米里兹	丹妮亚·拉米雷兹
罗兰德·艾默里克	罗兰·艾默里奇
尊拿·芬	约翰·芬
傅尊	约翰·芬
维吉妮·勒朵因	维吉妮·拉朵嫣
维赫瑞妮·勒朵因	维吉妮·拉朵嫣
维吉妮·勒杜瓦安	维吉妮·拉朵嫣
维吉尼·丽多茵	维吉妮·拉朵嫣
弗吉妮亚·拉朵嫣	维吉妮·拉朵嫣
费尔南多·梅雷莱斯	费尔南多·梅里尔斯
马修·阿玛里克	马修·阿马立克
马蒂尔艾马力	马修·阿马立克
马修·阿玛希克	马修·阿马立克
马修亚玛希	马修·阿马立克
莫莉卡·赫拉瓦特	玛丽卡·沙拉瓦特
莫妮卡·科尔曼	莫妮卡·克尔曼
拉里·金	拉里·金
阿尔登·艾伦瑞奇	阿尔登·埃伦瑞奇
阿尔登·迦勒·埃伦瑞奇	阿尔登·埃伦瑞奇
奥尔登·埃伦莱克	阿尔登·埃伦瑞奇
吉米·鸡毛	吉米·坎摩尔
吉米·金梅尔	吉米·坎摩尔
金·迪瑞科特	金·迪莱克特
朱利安·萧贝尔	朱利安·施纳贝尔
威廉·莫纳罕	威廉·莫纳汉
里卡多·斯卡马里奥	里卡多·斯卡马乔
金性洙	金成洙
李志远	李纬
吉娜·马龙	吉娜·马隆
艾碧康妮絲	艾比·考尼什
贾斯丁·廷布雷克	贾斯汀·汀布莱克
贾斯汀·汀伯雷克	贾斯汀·汀布莱克
贾斯丁·汀波莱克	贾斯汀·汀布莱克
贾斯汀·丁伯莱克	贾斯汀·汀布莱克
贾老板	贾斯汀·汀布莱克
罗莎曼德·派克	裴淳华
罗莎蒙德·派克	裴淳华
凯文·约瑟夫·席格斯	凯文·席格斯
凯文·希格斯	凯文·席格斯
晓高·韦荣	雨果·维文
雨果·威明	雨果·维文
休戈·威文	雨果·维文
罗文·艾金森	罗温·艾金森
罗文·阿特金森	罗温·艾金森
路云·雅坚逊	罗温·艾金森
憨豆先生	罗温·艾金森
艾米尔·荷许	埃米尔·赫斯基
埃米尔·赫施	埃米尔·赫斯基
雷恩·菲力浦	瑞恩·菲利普
莱恩·菲利普	瑞恩·菲利普
瑞安·菲利普	瑞恩·菲利普
艾丝拉·费雪	艾拉·菲舍尔
伊拉·费什	艾拉·菲舍尔
伊拉·菲舍尔	艾拉·菲舍尔
标·尼菲	比尔·奈伊
比·乃尔	比尔·奈伊
贝尼西奥·德尔托罗	本尼西奥·德尔·托罗
班尼西欧岱托洛	本尼西奥·德尔·托罗
贝尼裘·德托罗	本尼西奥·德尔·托罗
占·渣木殊	吉姆·贾木许
吉姆贾姆什	吉姆·贾木许
奶茶	刘若英
刘娜娜	刘若英
刘小奶	刘若英
安娜·费莉丝	安娜·法瑞丝
盖尔·加西亚·伯纳尔	盖尔·加西亚·贝纳尔
扎迦利·奎因特	扎克瑞·昆图
马里奥·玛瑞尔	马里奥·毛瑞尔
馬力歐·慕瑞	马里奥·毛瑞尔
馬力歐·莫瑞爾	马里奥·毛瑞尔
尊·麦高维治	约翰·马尔科维奇
约翰·马克维奇	约翰·马尔科维奇
艾什顿·库彻	阿什顿·库彻
艾什顿·库奇	阿什顿·库彻
艾斯顿·古查	阿什顿·库彻
艾希顿·库奇	阿什顿·库彻
玛丽·伊丽莎白·温斯泰德	玛丽·伊丽莎白·温斯特德
玛丽·伊丽莎白·文斯蒂德	玛丽·伊丽莎白·温斯特德
玛丽·伊丽莎白·温斯蒂	玛丽·伊丽莎白·温斯特德
冯·迪索	范·迪塞尔
云·迪素	范·迪塞尔
文·迪塞尔	范·迪塞尔
温·迪索	范·迪塞尔
加斯·范桑特	格斯·范·桑特
葛斯范桑	格斯·范·桑特
艾美莉·宾特	艾米莉·布朗特
艾蜜莉·布朗	艾米莉·布朗特
凯顿·基斯登逊	海登·克里斯滕森
海登·克里斯唐森	海登·克里斯滕森
布莱克·莱弗利	布蕾克·莱弗利
珍妮弗·卡彭特	詹妮弗·卡朋特
罗伯·洛	罗伯·劳
托妮·科莱特	托妮·科莱特
拉妲·米契尔	拉达·米切尔
莱达·米歇尔	拉达·米切尔
拉达·米契尔	拉达·米切尔
劳伦斯·霍莉	罗伦·荷莉
理查德·德莱福斯	理查德·德莱弗斯
西恩·杨	肖恩·杨
乌比·哥德堡	乌比·戈德堡
赛斯·麦克法兰	塞思·麦克法兰
贝弗莉·丹吉洛	比佛莉·德安姬罗
阿丽森·詹尼	艾莉森·珍妮
米凯·尼奎斯特	迈克尔·恩奎斯特
阿尔法·沃德	阿尔法·伍达德
卡罗琳·古道	卡罗琳·古多尔
萨姆·沃特斯通	萨姆·沃特森
劳伦·哈顿	劳伦·赫顿
休·博内威利	休·博纳维尔
加里·罗斯	盖瑞·罗斯
比勒·奥古斯特	比利·奥古斯特
斯蒂芬妮·奥德朗	斯特凡·奥德朗
阿兰·摩尔	艾伦·摩尔
阿城	郭富城
城仔	郭富城
城城	郭富城
阿王	郭富城
提姆西·道陵	蒂莫斯·道灵
列奥·卡拉克斯	莱奥·卡拉克斯
李欧卡霍	莱奥·卡拉克斯
阿Sa	蔡卓妍
艾赛儿汉宁	阿卡塞尔·亨涅
代果	余文乐
比尔·沃顿	比尔·沃尔顿
申铉睿	申贤俊
申铉浚	申贤俊
申铉濬	申贤俊
冢本高史	塚本高史
佐藤敦子	田中敦子
蔻琳·格里菲斯	科琳·格里菲斯
施祖南	施祖男
依晨	林依晨
依依	林依晨
小妞	林依晨
林小妞	林依晨
晨小妞	林依晨
一百零一层	林依晨
石头	石田彰
慧仪姐姐	张慧仪
性感女神	张慧仪
大马红宝石	张慧仪
朴韩星	朴寒星
朴寒别	朴寒星
朴韩屏	朴寒星
小宋佳	宋佳
小花	宋佳
吴老大	吴奇隆
四爷	吴奇隆
霹雳虎	吴奇隆
宝贝（昵称）	陈法蓉
杨允浩	梁允豪
杨允赫	梁允豪
梁允浩	梁允豪
申利	申伊
张成熙	申伊
温兆麟	温兆伦
大鬼	张致恒
陈思行	陈加玲
陈嘉玲	陈加玲
老My	胡杏儿
杏儿	胡杏儿
胡小杏	胡杏儿
马俊伟	马浚伟
延正勋	延政勋
连正勋	延政勋
廉政勋	延政勋
陈庆三	陈强
吴天心	天心
刘荣华	潘虹
夹子小应	应蔚民
郁方	郁芳
吕玉芳	郁芳
吕家柔	郁芳
梅甘·福克斯	梅根·福克斯
安柏·希尔德	艾梅柏·希尔德
安布尔·赫德	艾梅柏·希尔德
安柏·赫德	艾梅柏·希尔德
巨石强森	道恩·强森
德威恩·道格拉斯·约翰逊	道恩·强森
唐尼·约翰逊	道恩·强森
岩石	道恩·强森
巨石	道恩·强森
狄维庄逊	道恩·强森
大亨	亨利·卡维尔
罗莎里奥·唐森	罗莎里奥·道森
小哈里·沙姆	岑勇康
岑永康	岑勇康
丹尼斯·霍普	丹尼斯·霍珀
丹尼·特乔	丹尼·特雷霍
伊丽莎白·斯塔玛蒂娜·菲	蒂娜·菲
天娜·菲	蒂娜·菲
蒂娜·费	蒂娜·菲
威廉·莎士比亚	莎士比亚
布里吉特·莫纳罕	布丽姬·穆娜
碧姬蒙娜汉	布丽姬·穆娜
杰森·比格斯	贾森·比格斯
赵喜娜	约翰·塞纳
文森特·卡吉瑟	文森特·卡塞瑟
发哥	周润发
小马哥	周润发
雷米·马利克	拉米·马雷克
罗比·艾梅尔	罗比·阿美尔
罗比·阿梅尔	罗比·阿美尔
杰里·赛恩菲尔德	杰瑞·宋飞
杰里·宋飞	杰瑞·宋飞
玛格丽特摩洛	玛格丽特·莫罗
大卫·碧咸	大卫·贝克汉姆
乔·约翰斯顿	乔·庄斯顿
纳图里·瑙顿	娜图里·劳顿
指头叔	艾丹·吉伦
盖尔·加多特	盖尔·加朵
肥k 18线（昵称）	凯莉·克拉克森
泰森·里特尔	泰森·里特
安娜·穆哥拉丽	安娜·穆格拉利斯
安娜·莫格拉莉丝	安娜·穆格拉利斯
安娜·莫格拉莉	安娜·穆格拉利斯
菲利浦·诺伊斯	菲利普·诺伊斯
帕布罗·施雷柏	巴勃罗·施瑞博尔
贾克欧迪亚	雅克·欧迪亚
贾克欧狄亚	雅克·欧迪亚
雅克·奥迪亚尔	雅克·欧迪亚
罗内·莎菲	罗勒·莎菲
杰米·多南	詹米·多南
大虫	丹尼斯·罗德曼
米歇尔·歌美	米歇尔·戈麦兹
爱米丽·瑞尔丝	艾米莉·里奥斯
克莱尔·丹尼斯	克莱尔·德尼
克莱尔·德妮斯	克莱尔·德尼
阿米拉·卡萨	阿蜜拉·卡萨
王先生	王力宏
二哥	王力宏
岛田阳子	岛田阳子
莉娜·杜汉姆	莉娜·邓纳姆
莱纳·达南	莉娜·邓纳姆
小黄	乌尔里希·马特斯
阿纽林·巴纳德	阿奈林·巴纳德
奥德丽·韦尔斯	奥黛丽·威尔斯
雅思米娜·雷乍	雅丝米娜·雷札
让·吉哈	让·纪劳
让·吉罗	让·纪劳
小南瓜	贝哈蒂·朴琳思洛
小野D	小野大辅
小野大腐	小野大辅
小野妹子	小野大辅
夏木麻里	夏木真理
焦莉娜	焦姣
焦娇	焦姣
静姐	宁静
张扬	唐宸禹
唐詩詠	唐诗咏
唐诗盈	唐诗咏
唐思盈	唐诗咏
马赛·皮耶普莱兹卡	马切伊·佩普日察
高鲁	李天济
于刚	李天济
光沛	李天济
从珊	丛珊
陈恩耀	陈键锋
阿苗	陈键锋
苗苗	陈键锋
加勒特·赫德兰	加内特·赫德兰
加莱特·赫德兰	加内特·赫德兰
玛丽莎·图梅	玛丽莎·托梅
何加男	梅艳芳
华金·菲尼克斯	杰昆·菲尼克斯
约瑟夫 法因斯	约瑟夫·费因斯
佐伊·桑塔纳	佐伊·索尔达娜
柔依·莎唐娜	佐伊·索尔达娜
素儿·莎丹娜	佐伊·索尔达娜
黛咪·摩尔	黛米·摩尔
汤姆·泰克维尔	汤姆·提克威
汤姆·蒂克威	汤姆·提克威
埃娃·隆戈里亚	伊娃·朗格利亚
伊娃·朗格利亚·帕克	伊娃·朗格利亚
艾娃·朗格利亚	伊娃·朗格利亚
希里安·墨菲	基里安·墨菲
斯里安·墨菲	基里安·墨菲
克里安·墨菲	基里安·墨菲
克里安·墨菲	基里安·墨菲
施利安梅菲	基里安·墨菲
S妞	赛琳娜·戈麦斯
傻脸娜	赛琳娜·戈麦斯
割麦子	赛琳娜·戈麦斯
席尔维斯史泰龙	西尔维斯特·史泰龙
周董	周杰伦
小公举	周杰伦
杰克·格莱恩哈尔	杰克·吉伦哈尔
杰克·葛伦霍	杰克·吉伦哈尔
杰克·吉伦希尔	杰克·吉伦哈尔
杰克·盖伦哈尔	杰克·吉伦哈尔
希芙嘉咸	海瑟·格拉汉姆
星爷	周星驰
周星星	周星驰
安妮·夏菲維	安妮·海瑟薇
莉莉高爾	莉莉·科尔
阿丽·格雷诺	艾莉·葛瑞那
阿丽·格雷勒	艾莉·葛瑞那
安迪·麦克道尔	安迪·麦克道威尔
荣雷美斯	文·瑞姆斯
雪莉·麦克莱恩	雪莉·麦克雷恩
莎莉·麦克琳	雪莉·麦克雷恩
哈威·凯特	哈威·凯特尔
哈威·凯托	哈威·凯特尔
哈维·凯托	哈威·凯特尔
哈维·凯特尔	哈威·凯特尔
芭芭拉·斯特雷桑德	芭芭拉·史翠珊
塔里亚·希雷	塔莉娅·夏尔
理查德·杰金斯	理查德·詹金斯
克雷格·费格斯	克雷格·费格森
奥森·威尔斯	奥逊·威尔斯
泰勒·拉拜	泰勒·莱伯恩
保罗·马祖尔斯基	保罗·马祖斯基
詹姆斯·贝瑞	J·M·巴利
詹姆斯·巴里	J·M·巴利
费多尔·邦达尔丘克	费奥多尔·邦达尔丘克
姜昌年	秦沛
总攻大人	小西克幸
渡部笃	渡部笃郎
邓健弘	邓健泓
草蜢	苏志威
贾森·斯塔森	杰森·斯坦森
积逊·史特咸	杰森·斯坦森
郭达·斯坦森	杰森·斯坦森
泰拉姬·汉森	塔拉吉·P·汉森
汤姆·福尔顿	汤姆·费尔顿
汤·费顿	汤姆·费尔顿
汤老湿	汤姆·哈迪
甜心	汤姆·哈迪
米切尔·威廉姆斯	米歇尔·威廉姆斯
米雪·威廉丝	米歇尔·威廉姆斯
積·伯克	杰克·布莱克
小粉	亚伦·保尔
史蒂芬·弗莱	斯蒂芬·弗雷
伊德瑞斯·艾尔巴	伊德里斯·艾尔巴
薇吉妮亚麦德森	维吉妮娅·马德森
维吉尼亚·马德森	维吉妮娅·马德森
维斯·巴特利	韦斯·本特利
珍妮佛·提莉	詹妮弗·提莉
萨姆·尼尔	山姆·尼尔
内奥米·哈里斯	娜奥米·哈里斯
娜奥梅·哈里斯	娜奥米·哈里斯
尼奥梅·哈里斯	娜奥米·哈里斯
史蒂芬·金	斯蒂芬·金
斯科特·肯	斯科特·凯恩
斯科特·坎	斯科特·凯恩
斯科特·安德鲁·凯恩	斯科特·凯恩
约什·查尔斯	乔西·查尔斯
大卫温翰	大卫·文翰
劳伦·巴考尔	劳伦·白考尔
罗兰·比歌	劳伦·白考尔
马田·费曼	马丁·弗瑞曼
马丁·弗里曼	马丁·弗瑞曼
潮爷	马丁·弗瑞曼
小自由	马丁·弗瑞曼
迈克尔·切克里斯	迈克尔·切克利斯
科比·宾恩·布莱恩特·考克斯	科比·布莱恩特
高比·拜仁	科比·布莱恩特
克里斯滕·庄斯顿	克莉丝汀·约翰斯顿
克里斯坦·约翰逊	克莉丝汀·约翰斯顿
柯克·帕尔莫	柯柯·帕尔莫
梅丽莎·迈卡锡	梅丽莎·麦卡西
吉米·法隆	吉米·法伦
乔·本恩瑟	乔·博恩瑟
布鲁斯·斯彭斯	布鲁斯·斯宾斯
贾里德·哈里斯	杰瑞德·哈里斯
杰拉德·哈里斯	杰瑞德·哈里斯
朱莉·冈萨洛	朱丽叶·冈扎罗
巴兹·鲁曼	巴兹·鲁赫曼
巴兹·鲁尔曼	巴兹·鲁赫曼
巴兹雷曼	巴兹·鲁赫曼
达里奥·阿金图	达里奥·阿基多
莉莉·汤普琳	莉莉·汤姆林
丽丽·汤普林	莉莉·汤姆林
小埃德·贝格利	小艾德·博格里
安风	刘亦菲
刘茜美子	刘亦菲
瑞切尔·沃德	蕾切尔·沃德
汤姆.福德	汤姆·福特
伯恩·乔曼	伯恩·戈曼
诺米·勒努尔	诺米·勒努瓦
哈里·垂德威	哈里·崔德威
丹尼尔波哈特	丹尼尔·伯哈特
阿菲·艾伦	阿尔菲·艾伦
保罗·法伊格	保罗·费格
阿米·哈默	艾米·汉莫
阿米·汉莫	艾米·汉莫
锤子	艾米·汉莫
斯维利·固德纳松	斯瓦利尔·古德纳松
斯维尔·古德纳松	斯瓦利尔·古德纳松
思维瑞尔·古德纳松	斯瓦利尔·古德纳松
马克·罗森	马克·容森
马克·荣森	马克·容森
瑞特·盖艾斯	雷特·盖尔斯
霆锋	谢霆锋
范爷	范冰冰
黄爹（昵称）	黄秋生
黄爸（昵称）	黄秋生
生抽王（小名）	黄秋生
艾德·所罗门	艾德·索罗门
杰克·科尔比	杰克·科比
欧亨尼奥·德尔维斯	欧赫尼奥·德尔维斯
帕斯卡·格利高里	帕斯卡尔·格雷戈里
詹姆斯·沙姆斯	詹姆斯·夏慕斯
詹士·沙姆斯	詹姆斯·夏慕斯
詹姆斯·薛默斯	詹姆斯·夏慕斯
陈慧汶	陈慧琳
让-克劳德·卡里埃尔	让-克洛德·卡里埃
保罗·科尔贺	保罗·柯艾略
保罗·科埃略	保罗·柯艾略
雅利尔·莱斯佩尔	加里·勒斯培
藤竜也	藤龙也
达也富士	藤龙也
克里斯托弗·琼勒	克里斯托弗·约纳尔
克里斯托弗·琼尔	克里斯托弗·约纳尔
乖乖虎	苏有朋
谭校长	谭咏麟
亚伦	谭咏麟
阿伦	谭咏麟
J·B·普里斯特利	约翰·博因顿·普里斯特利
靓靓	袁咏仪
華哥	黄日华
绵羊	松田翔太
本诺特·德尔平	伯努瓦·德雷平
仲村彻	仲村亨
海伦·樊尚	海伦·文森特
美女芬	蔡少芬
叉烧芬	蔡少芬
凉凉	蔡少芬
柳五成	刘五性
刘五胜	刘五性
黎登勤（本名）	周群达
杨佑宁	杨祐宁
楊祐寧	杨祐宁
樋口明日香	樋口明日嘉
贤荣	玄英
周丽琪	周丽淇
彪哥	范伟
赵文君	叶全真
葉全真	叶全真
水灵	蒋勤勤
梶裕貴	梶裕贵
孝哥	梶裕贵
浩浩	谭竣浩
萧雄	肖雄
孔镱珊	孔维
孔薇薇	孔维
Leno Holbrook (子）	波伊德·霍布鲁克
克莉丝汀·阿奎莱拉	克里斯蒂娜·阿奎莱拉
克莉丝汀.阿奎莉娜	克里斯蒂娜·阿奎莱拉
乔什·赖安·哈切森	乔什·哈切森
凯蒂·赫尔姆斯	凯蒂·霍尔姆斯
凯蒂·福尔摩斯	凯蒂·霍尔姆斯
凯瑟琳·诺艾尔·赫尔姆斯	凯蒂·霍尔姆斯
吉姆·斯特加斯	吉姆·斯特吉斯
占史杜哲斯	吉姆·斯特吉斯
吉姆·史特格斯	吉姆·斯特吉斯
伍迪·哈瑞尔森	伍迪·哈里森
罗拔森·米基斯	罗伯特·泽米吉斯
劳勃辛·密克斯	罗伯特·泽米吉斯
罗伯特·赞米基斯	罗伯特·泽米吉斯
罗伯特·泽米基斯	罗伯特·泽米吉斯
凯瑟琳·比奇洛	凯瑟琳·毕格罗
凯瑟琳·碧露	凯瑟琳·毕格罗
丹尼尔·布尔	丹尼尔·布鲁尔
丹尼尔·布鲁赫	丹尼尔·布鲁尔
仓鼠	丹尼尔·布鲁尔
丹尼尔·塞萨尔·马丁·布吕尔·冈萨雷斯·多明戈	丹尼尔·布鲁尔
科华士·韦德加	福里斯特·惠特克
科力士·韋德加	福里斯特·惠特克
戴安·基顿	黛安·基顿
罗拉·琳妮	劳拉·琳妮
劳拉·林尼	劳拉·琳妮
唐奇多	唐·钱德尔
唐奇铎	唐·钱德尔
唐·奇杜	唐·钱德尔
迈克尔·凯拉	迈克尔·塞拉
孙颜王	孙红雷
孙漂亮	孙红雷
克莱尔·丹丝	克莱尔·丹妮丝
克莱尔·丹妮丝	克莱尔·丹妮丝
克莱尔·丹尼斯	克莱尔·丹妮丝
克莱儿·丹妮丝	克莱尔·丹妮丝
墙花	罗根·勒曼
卢根·利文	罗根·勒曼
维拉·法梅加	维拉·法米加
慧娜·花美嘉	维拉·法米加
阿曼达·希耶福里德	阿曼达·塞弗里德
阿曼达·西耶弗里德	阿曼达·塞弗里德
蕾切尔·麦克亚当斯	瑞秋·麦克亚当斯
麗素·麥阿當絲	瑞秋·麦克亚当斯
坤少	陈坤
坤儿	陈坤
坤哥	陈坤
厂花	陈坤
米高·德格拉斯	迈克尔·道格拉斯
克里斯托弗·怀特洛·派恩	克里斯·派恩
克里斯·潘恩	克里斯·派恩
班·巴恩斯	本·巴恩斯
瑞安·雷诺兹	瑞恩·雷诺兹
瑞安·罗尼·雷诺茲	瑞恩·雷诺兹
张睿玲	张睿羚
张敏仪	张睿羚
伊莎贝拉·卢卡斯	伊莎贝尔·卢卡斯
克劳德·察布罗尔	克洛德·夏布洛尔
克劳德·查布洛	克洛德·夏布洛尔
陈思文	谷峰
马丁·希恩	马丁·辛
冯宏源	午马
爱德华·埃斯诺	爱德华·阿斯纳
卢燕英	罗兰
克劳斯·利特曼	克萝丽丝·利奇曼
老猫	子安武人
萨拉·杰西卡·帕克	莎拉·杰茜卡·帕克
莎拉·谢茜嘉·柏嘉	莎拉·杰茜卡·帕克
莎拉·杰西卡·帕克	莎拉·杰茜卡·帕克
海伦米兰	海伦·米伦
史提夫卡路爾	史蒂夫·卡瑞尔
华纳·荷索	沃纳·赫尔佐格
维尔纳·赫尔佐格	沃纳·赫尔佐格
维尔内纳·赫尔措格	沃纳·赫尔佐格
老谋子	张艺谋
国师	张艺谋
张诒谋	张艺谋
史提芬索德堡	史蒂文·索德伯格
伊桑·柯恩	伊桑·科恩
伊顿·高安	伊桑·科恩
伊森·柯恩	伊桑·科恩
科恩兄弟	伊桑·科恩
高安兄弟	伊桑·科恩
柯恩兄弟	伊桑·科恩
森姆·積遜	塞缪尔·杰克逊
史蒂夫·布塞米	史蒂夫·布西密
斯蒂夫·巴塞米	史蒂夫·布西密
伊安·麦克莱恩	伊恩·麦克莱恩
伊安·麦克凯伦	伊恩·麦克莱恩
伊恩·麦克连	伊恩·麦克莱恩
伊恩·麦凯伦	伊恩·麦克莱恩
希拉里·斯旺克	希拉里·斯万克
班史迪拿	本·斯蒂勒
荷尔芭莉	哈莉·贝瑞
海儿贝莉	哈莉·贝瑞
哈里·贝瑞	哈莉·贝瑞
哈莉·玛丽亚·贝瑞	哈莉·贝瑞
烈尼史葛	雷德利·斯科特
里德利斯科特	雷德利·斯科特
蕾妮·泽尔维格	蕾妮·齐薇格
芮妮·齐薇格	蕾妮·齐薇格
蕾妮·泽尔薇格	蕾妮·齐薇格
瑞妮·齐威格	蕾妮·齐薇格
云妮·施维嘉	蕾妮·齐薇格
法兰西斯福特哥普拉	弗朗西斯·福特·科波拉
金马伦戴雅丝	卡梅隆·迪亚兹
卡梅伦·迪亚丝	卡梅隆·迪亚兹
卡梅隆·迪亚茨	卡梅隆·迪亚兹
刘福荣	刘德华
华仔	刘德华
马丁·斯科西斯	马丁·斯科塞斯
马田史高西斯	马丁·斯科塞斯
马丁史柯席斯	马丁·斯科塞斯
马丁·斯科塞西	马丁·斯科塞斯
约翰·屈伏塔	约翰·特拉沃尔塔
尊特·拉华达	约翰·特拉沃尔塔
约翰·特拉沃尔塔	约翰·特拉沃尔塔
克尔斯滕·邓斯特	克斯汀·邓斯特
克里斯汀·邓斯特	克斯汀·邓斯特
克里斯滕·邓斯特	克斯汀·邓斯特
克莉丝汀·邓斯特	克斯汀·邓斯特
姬丝汀·登丝	克斯汀·邓斯特
柯丝婷·邓斯特	克斯汀·邓斯特
丹素华盛顿	丹泽尔·华盛顿
丹佐华盛顿	丹泽尔·华盛顿
凯文·史佩西	凯文·史派西
凯文·斯帕西	凯文·史派西
凯文·斯贝西	凯文·史派西
奇云史帕西	凯文·史派西
汤告鲁斯	汤姆·克鲁斯
阿汤哥	汤姆·克鲁斯
奇连伊士活	克林特·伊斯特伍德
克林伊斯威特	克林特·伊斯特伍德
东木头	克林特·伊斯特伍德
梅丽·史翠普	梅丽尔·斯特里普
梅莉·史翠普	梅丽尔·斯特里普
梅姨	梅丽尔·斯特里普
史提芬·史匹堡	史蒂文·斯皮尔伯格
史蒂芬·斯皮尔伯格	史蒂文·斯皮尔伯格
斯蒂文·斯皮尔伯格	史蒂文·斯皮尔伯格
史蒂芬·史匹柏	史蒂文·斯皮尔伯格
姬蒂·白兰芝	凯特·布兰切特
凯特·布兰琪	凯特·布兰切特
大魔王	凯特·布兰切特
妮歌洁曼	妮可·基德曼
妮科尔基曼	妮可·基德曼
马特·戴蒙	马特·达蒙
麦特戴蒙	马特·达蒙
麥迪文	马特·达蒙
昆汀塔伦天奴	昆汀·塔伦蒂诺
昆汀塔伦提诺	昆汀·塔伦蒂诺
罗拔·迪尼路	罗伯特·德尼罗
劳勃·狄尼洛	罗伯特·德尼罗
凯拉·奈特莉	凯拉·奈特莉
凯拉·奈特利	凯拉·奈特莉
姬拉丽莉	凯拉·奈特莉
汤汉斯	汤姆·汉克斯
汤姆汉克	汤姆·汉克斯
阿尔柏仙奴	阿尔·帕西诺
艾尔·帕西诺	阿尔·帕西诺
毕彼特	布拉德·皮特
布莱德彼特	布拉德·皮特
斯佳丽·乔安森	斯嘉丽·约翰逊
斯嘉丽·约翰松	斯嘉丽·约翰逊
斯嘉丽·琼森	斯嘉丽·约翰逊
史嘉莉·祖轩逊	斯嘉丽·约翰逊
寡姐	斯嘉丽·约翰逊
汤包	斯嘉丽·约翰逊
娜塔丽·波特曼	娜塔莉·波特曼
娜塔丽·波曼	娜塔莉·波特曼
娜塔莉·波曼	娜塔莉·波特曼
尼古拉斯·基治	尼古拉斯·凯奇
尼古拉斯·金·科波拉	尼古拉斯·凯奇
尊尼狄普	约翰尼·德普
强尼戴普	约翰尼·德普
尊尼特普	约翰尼·德普
佐治鲁卡斯	乔治·卢卡斯
比尔·墨瑞	比尔·默瑞
比尔·默里	比尔·默瑞
比尔·莫雷	比尔·默瑞
小莫里斯·约瑟夫·米克尔怀特	迈克尔·凯恩
珍妮弗·加纳	詹妮弗·加纳
奥利华史东	奥利佛·斯通
奥立弗史东	奥利佛·斯通
奥利弗·斯通	奥利佛·斯通
爱玛·汤逊	艾玛·汤普森
爱玛·汤普森	艾玛·汤普森
埃玛·汤普森	艾玛·汤普森
伊莎贝勒·雨蓓	伊莎贝尔·于佩尔
伊莎贝尔·休伯特	伊莎贝尔·于佩尔
伊莎贝尔·于蓓尔	伊莎贝尔·于佩尔
伊莎贝尔·于贝尔	伊莎贝尔·于佩尔
乔·科恩	乔尔·科恩
约尔·科恩	乔尔·科恩
祖尔·高安	乔尔·科恩
乔伊·柯恩	乔尔·科恩
科恩兄弟	乔尔·科恩
高安兄弟	乔尔·科恩
柯恩兄弟	乔尔·科恩
朱利安·摩尔	朱丽安·摩尔
朱莉安·摩尔	朱丽安·摩尔
茱莉安·摩亚	朱丽安·摩尔
朱莉安娜·摩尔	朱丽安·摩尔
咩姨	朱丽安·摩尔
维果·莫特森	维果·莫腾森
维果·莫坦森	维果·莫腾森
维戈·莫特森	维果·莫腾森
维格·蒙坦森	维果·莫腾森
亚当山德勒	亚当·桑德勒
陈港生	成龙
房仕龙	成龙
朱丽娅·罗伯茨	朱莉娅·罗伯茨
茱莉亚罗拔斯	朱莉娅·罗伯茨
茱莉亚罗勃兹	朱莉娅·罗伯茨
茱莉亚罗拔丝	朱莉娅·罗伯茨
茱莉亚罗伯茨	朱莉娅·罗伯茨
史丹利寇比力克	斯坦利·库布里克
史丹利库布里克	斯坦利·库布里克
摩根费曼	摩根·弗里曼
龙卷风	达伦·萨赫拉维
JJサニー千葉	千叶真一
和千永倫道	千叶真一
前田禎穂	千叶真一
乔恩·亚伯拉罕	乔·阿布拉汉姆斯
乔治·汉弥顿	乔治·汉密尔顿
特拉维斯·特里特	崔维斯·崔特
玛丽安·吉恩-巴普迪斯特	玛丽安娜·琼-巴普蒂斯特
珍·寇汀	简·库丁
元龙（昵称）	洪金宝
朱元龙	洪金宝
苏菲亚维佳乐	索菲娅·维加拉
尚杰克‧安诺	让-雅克·阿诺
麦尔·温宁汉姆	梅尔·温宁汉姆
托德·贝考科	泰德·巴勃考克
卡洛斯·阿拉兹拉奎	卡洛斯·阿拉斯拉奇
崔斯·艾金斯	特雷斯·阿德金斯
米歇尔·昂	米歇尔·洪
艾瑞克·安东尼·奥德	艾瑞克·奥德
姬丝·阿基诺	姬丝·阿奎诺
克里丝·阿基诺	姬丝·阿奎诺
JR·伯恩	JR·波恩
送葬者	马克·卡拉韦
嘟嘟	郑裕玲
阿叻	陈百祥
叻哥	陈百祥
荷兰叻	陈百祥
大卫·克洛斯	大卫·克罗斯
二小姐	张可颐
蒋介石	蒋中正
拉里·科恩	拉里·柯恩
陈小臻	陈小春
陳芷菁	陈芷菁
陈芷青	陈芷菁
塔基·科昂	塔伊加·维迪提
泰格·韦替替	塔伊加·维迪提
泰卡·怀蒂蒂	塔伊加·维迪提
张瑛	张爱玲
梁京	张爱玲
陈兴华	陈冠希
戴夫·查佩尔	大卫·查普尔
凯特·弗拉奈芮	凯特·弗兰纳里
杰森·大卫·弗兰科	杰森·弗兰克
帕特里克·法碧昂	帕特里克·法比安
洛雷塔·戴维尼	洛雷塔·迪瓦恩
梅根·杜德斯	梅根·多兹
丽贝卡·路易莎·弗格森	丽贝卡·弗格森
丽贝卡·路易莎·弗格森·桑斯特伦	丽贝卡·弗格森
本诺·福尔曼	本诺·菲尔曼
班诺欧·福曼	本诺·菲尔曼
维克托·埃里切	维克多·艾里斯
芝see菇bi	卓韵芝
二瓶康一	火野正平
约翰·哈克斯	约翰·浩克斯
约翰·霍克斯	约翰·浩克斯
约瑟芬·戈登·罗维特	约瑟夫·高登-莱维特
囧瑟夫	约瑟夫·高登-莱维特
祖瑟夫·哥顿·利域	约瑟夫·高登-莱维特
梅拉尼·洛朗	梅拉尼·罗兰
玛丽莲·洛伦	梅拉尼·罗兰
梅勒尼·劳伦	梅拉尼·罗兰
梅兰妮·洛宏	梅拉尼·罗兰
李惠敏	李蕙敏
欣欣	江欣燕
金玟廷	金敏贞
金敏珍	金敏贞
金兑容	金泰勇
迈克尔·巴卡里·乔丹	迈克尔·B·乔丹
布莱恩·杰夫·克劳斯	布莱恩·克劳斯
吴静怡	伊能静
伊能静江	伊能静
王德兰	王莱
罗行堂	罗家英
李月玲	李琳琳
休·劳里	休·劳瑞
晓·莱利	休·劳瑞
舒庆春	老舍
舒舍予	老舍
阿基·郭利斯马基	阿基·考里斯马基
李芸敏	李艺民
梨芸珉	李艺民
李刚	李艺民
李小桐	李艺民
三哥	苗侨伟
伟仔	梁朝伟
老虎	梁朝伟
霍尔特·麦克卡兰尼	霍特·麦克卡兰尼
林漫威	林-曼努尔·米兰达
掌门	吕颂贤
冼锦熙	刘家辉
麦克·纳德	迈克尔·纳德
三姑	吴君如
小如	吴君如
朴元勇	朴云龙
朴云永	朴云龙
村上龍	村上龙
奥妹	伊丽莎白·奥尔森
长	长岛雄一
長島茂	长岛雄一
長島雄一	长岛雄一
迈可尔·贝尼亚	迈克尔·佩纳
大杉漣	大杉涟
特里·穆尔	泰瑞·摩尔
林立慧	舒淇
威尔·罗斯海	威尔·罗斯海尔
大傻	成奎安
迈克尔·香农	迈克尔·珊农
艾茵·兰德	安·兰德
马提亚斯·修奈尔茨	马提亚斯·修奈尔
教授	坂本龙一
奥托维亚·斯宾塞	奥克塔维亚·斯宾瑟
查德.史塔尔斯基	查德·斯塔赫斯基
朱恩·斯奎布	琼·斯奎布
詹妮弗·比尼·泰勒（全名）	詹妮弗·泰勒
維埃裡	克里斯蒂安·维耶里
韋利	克里斯蒂安·维耶里
囧豪	谢君豪
伊丽莎白·宋	孙芳
肥肥	沈殿霞
开心果	沈殿霞
武田鉄矢	武田铁矢
邓翠雯	邓萃雯
杜琪峯	杜琪峰
雪茄杜	杜琪峰
拉里·沃卓斯基	拉娜·沃卓斯基
拉娜·华高斯基	拉娜·沃卓斯基
拉娜·华卓斯基	拉娜·沃卓斯基
拉娜·瓦霍夫斯基	拉娜·沃卓斯基
岳陽	岳阳
阿荣	叶世荣
薇薇	赵薇
小薇	赵薇
小燕子	赵薇
夏令震	元彪
大冢芳忠	大塚芳忠
翁华荣	华荣翁
任细官	任世官
任小官	任世官
陈硕修（本名）	石修
祖儿 小贤	王祖贤
迪·沃莱斯	迪·沃伦斯
布兰迪·卡莱尔	布兰迪·卡莉
万刀甲	方力申
海蒂·玛尼梅可	海蒂·莫尼梅克
独狼	斯蒂芬·马布里
马政委	斯蒂芬·马布里
杨泽嬅	杨千嬅
大笑姑婆	杨千嬅
千FA	杨千嬅
小罗	罗纳尔迪尼奥
骚当	亚当·莱文
亚当·李维	亚当·莱文
凯瑟琳·牛顿	凯瑟琳·纽顿
迪安·维斯特	迪恩·J·韦斯特
马克·“犀牛”·史密斯	马克·史密斯
杰登·沙达	杰里米·沙达
弗拉基米尔·科斯洛弗	奥列格·普鲁迪乌斯
弗拉基米尔·科兹洛夫	奥列格·普鲁迪乌斯
蘿蘋貝恩	罗宾·贝恩
艾米丽·罗亚·奥布莱恩（本名）	艾米丽·奥布莱恩
边锡峰	边熙峰
边熙奉	边熙峰
刘天花	田华
汉密什·布雷克	韩秘书·布雷克
拉拉·格莱斯	拉腊·格赖斯
山姆·修汉	萨姆·修汉
安娜蘇菲亞	安娜索菲亚·罗伯
罗伯特·巴乔	罗伯托·巴乔
阿肥	李思捷
荃加壽	李思捷
捷爷	李思捷
车太铉	车太贤
穆大叔	迪肯贝·穆托姆博
旺德雷拉·席尔瓦	万德雷·席尔瓦
亓亮	奇道
亓道	奇道
齐道	奇道
张新英	张申英
莎娃	玛利亚·莎拉波娃
李名顺	李铭顺
梁乐瑶	梁洛施
加瀬亮	加濑亮
金刚于	金康宇
金江宇	金康宇
金强宇	金康宇
道总	马特·贝里
蒂芬妮·哈迪什	蒂凡尼·哈迪斯
成太生	成泰燊
成太森	成泰燊
徐文健	徐天佑
宋惠教	宋慧乔
马婶	马特·史密斯
赵燕	沈傲君
蘇菲亞 寶堤拉（港）	索菲亚·波多拉
吳建豪	吴建豪
释行宇	释彦能
张淑武	释彦能
释延能	释彦能
托尼·雷沃洛利	托尼·雷沃罗利
鲍比·莫伊尼汉	鲍比·莫尼汉
博比·莫伊尼汉	鲍比·莫尼汉
李俊基	李准基
罗沙‧布克维	拉蒂沃杰·布克维奇
乔什·波恩	约什·布恩
AJ 斯泰尔斯	艾伦·琼斯
费德里科·阿尔瓦雷兹	费德·阿尔瓦雷兹
梅玲·梅纳康	梅·梅纳康
杰克·威尔瑞	杰克·威利
盖奇·格莱特利	盖琦·格莱特利
小甜瓜	卡梅隆·安东尼
陈韦志	陈柏霖
斯蒂芬·阿美尔	斯蒂芬·阿梅尔
黑暗之子	李东健
豪梅·科列特-塞拉	佐米·希尔拉
小镁	桂纶镁
桥本由宇	苍井空
朴哲敏	朴哲民
金志英	韩彩英
奥玛·赛	奥玛·希
金館長	崔成国
凯蒂·阿瑟尔顿	凯蒂·阿赛尔顿
郑烈琼	郑希怡
郑列琼	郑希怡
秋子贤	秋瓷炫
秋恩珠	秋瓷炫
迈克·米赞宁（昵称）	迈克尔·米赞宁
米兹（昵称）	迈克尔·米赞宁
迈克尔·格雷戈里·米赞宁（全名）	迈克尔·米赞宁
迈克·米赞尼	迈克尔·米赞宁
权相佑	权相宇
郎逸群	郎朗
南宫民	南宫珉
蒂凡妮·玛斯兰尼	塔提阿娜·玛斯拉尼
冰人	乔治·格文
佐伊·克拉维茨	佐伊·克罗维兹
利亚姆·麦金泰尔	连姆·麦肯泰尔
贝尔·波利	蓓尔·波利
赵太奎	姜至奂
姜智焕	姜至奂
姜志焕	姜至奂
珍妮·斯蕾	珍妮·斯蕾特
泰勒·哈里斯	赛尔·哈里斯
坎妹	艾丽西亚·维坎德
埃扎·冈萨雷斯	艾莎·冈萨雷斯
金·卡达珊	金·卡戴珊
詹姆斯·赫伯特	詹姆斯·兰德里·赫伯特
雅姆·朗德里·埃贝尔	詹姆斯·兰德里·赫伯特
热狗	姚中仁
罗马王子	弗朗西斯科·托蒂
金小妹	肯多尔·詹纳
肯豆	肯多尔·詹纳
丹妮尔·莱丽·吉欧	丽莉·克亚芙
莱丽·吉欧	丽莉·克亚芙
魔兽	德怀特·霍华德
夏延·杰克逊	夏恩·杰克逊
李威乐	李逸朗
李家俊	李逸朗
希雅·凯特·伊索贝尔·富勒	希雅
希雅·富勒	希雅
洗牙	希雅
李郁	李钰
李欣	李钰
布兰特·道格蒂	布兰特·道格尔迪
布兰特·道格迪	布兰特·道格尔迪
布兰特·多尔蒂	布兰特·道格尔迪
布兰特·道尔蒂	布兰特·道格尔迪
布兰特·大卫·道格尔迪	布兰特·道格尔迪
凯特·米古奇	凯特·米库奇
凯特·米库契	凯特·米库奇
阿比·埃利奥特	艾比·艾略特
希莫斯	希莫斯
泰哥	泰勒·席林
藤冈龙雄	藤冈靛
电眼娃娃	张韶涵
排骨	张韶涵
馬明	马国明
弗兰基·埃德加	弗兰克·埃德加
刘芳绮	刘丹
托德·约瑟夫·米勒	T·J·米勒
曼纽尔·加西亚·鲁佛	曼努埃尔·加西亚-鲁尔福
王太	李亚男
阿嫂	李亚男
老板娘	李亚男
楊思琦	杨思琦
阿宝	曾宝仪
宝仪	曾宝仪
李英勋	李永勋
金牌皇后	陈莎莉
慈禧专业户	陈莎莉
演太后成精	陈莎莉
安倍春香	安部春香
阿兰·里奇森	阿兰·里奇森
马修·D·马特奥	马修·德斯里普
斯黛西·奥瑞斯塔诺	斯塔西·奥里斯塔诺
师姐（昵称）	艾里珊·钟
黄志中	黄志忠
丁门庆	蒂姆·明钦
柯特妮·帕姆	考特妮·帕姆
张钧宁	张钧甯
总裁	张钧甯
呆甯	张钧甯
钧钧	张钧甯
乔伊·保罗利	乔伊·保罗瑞
约瑟夫·保罗利	乔伊·保罗瑞
祖儿	乔伊·保罗瑞
思麒	李小冉
小天	阮经天
雨神	萧敬腾
蔡于位	蔡於位
胜利	李昇炫
小S	徐熙娣
婷婷	徐熙娣
盖盖	王天尉
关垚淼	瑶淼
小美	贺军翔
贺小美	贺军翔
黄怡	海清
托马斯·曼恩	托马斯·曼
曹志翔	高以翔
王绍伟	王少伟
沈鹤	小沈阳
吕孔维	九孔
冬叔	周冬雨
小黄鸭	周冬雨
小宇	李宇春
春春	李宇春
郭广习	郭晓东
郭晓冬	郭晓东
玛姬，曼神（影迷昵称）	张曼玉
阿宽	陈庆嘉
聂宏风	陈庆嘉
王浩賢	王祖蓝
蕭亮	王祖蓝
祖藍哥哥	王祖蓝
靚仔藍	王祖蓝
王公子	王祖蓝
荃加祿	王祖蓝
阿祿	王祖蓝
小志偉	王祖蓝
藍藍	王祖蓝
王老板	王祖蓝
吴佳丽	吴家丽
渤哥	黄渤
关维鹏	泰迪·罗宾
李导演	李力持
大力	李力持
东莞仔	李力持
杰森·斯坦达（昵称）	郭达
鞠萍姐姐	鞠萍
子子	张子枫
廖啟智	廖启智
闰土嫂	谢娜
娜娜	谢娜
娜姐	谢娜
坡姐	谢娜
陈庆祥	阿牛
林捷	林雪
黄乐桐	黄真真
小江	江一燕
爬爬	江一燕
江燕	江一燕
小宝	尔冬升
爾冬陞	尔冬升
姜小兵	姜武
段龙	段奕宏
李俊文	李治廷
秦小岚	秦岚
柳永青	柳云龙
牛山争	徐峥
山争哥哥	徐峥
徐铮	徐峥
王洛丹	王珞丹
丹总	王珞丹
丹丹	王珞丹
大丹	王珞丹
丹姐	王珞丹
熊猫丹	王珞丹
邓丽群	夏文汐
德云班主	郭德纲
倪大洪	倪大红
倪大宏	倪大红
陈大发	陈意涵
小猪	罗志祥
罗主任	罗志祥
罗祥	罗志祥
罗姓少年	罗志祥
罗娘娘	罗志祥
朱碧石	罗志祥
小太阳	钟汉良
小哇	钟汉良
连长	张涵予
王日祥	王晶
不是女人	王晶
史恒侠	芙蓉姐姐
毛毛	毛舜筠
江柏樑	叶念琛
陈澍	陈数
仔仔	周渝民
笹本春马	三浦春马
J·J·菲尔德	约翰·约瑟夫·菲尔德
吕玉来	吕聿来
小雨	朱雨辰
章金莱	六小龄童
钟阿城	阿城
豆导	钮承泽
豆子	钮承泽
钮祜禄·承泽	钮承泽
陈莎莎	陈紫函
陈紫涵	陈紫函
笔笔	周笔畅
周小笔	周笔畅
石仁茂	石班瑜
石斑鱼	石班瑜
石兆采	石班瑜
技安	刘镇伟
菩提老祖	刘镇伟
祥仔	黎耀祥
柴九哥	黎耀祥
醒哥	黎耀祥
苑丽琼	苑琼丹
Benz雄	许绍雄
岑建勛	岑建勋
胡柯	胡歌
糖糖	唐嫣
糖妞	唐嫣
糖囡	唐嫣
美糖	唐嫣
梁益俊	梁益准
梁益準	梁益准
杨若曦	杨若兮
十三姐	孙燕姿
郑日宇	丁一宇
郑日佑	丁一宇
张爽	张雨绮
大美	闫妮
艳艳	闫妮
阎妮	闫妮
姚鲁	姚橹
冯萃帆	冯淬帆
阿紧	冯淬帆
郎益三	郎雄
舒妃	郭碧婷
鍾舒漫	钟舒漫
钟舒曼	钟舒漫
刘诗施	刘诗诗
冯明光	冯巩
阿杰	周杰
玲玲	戴春荣
陈滢	陈莹
陆九九	陆诗雨
时小满	石小满
梁日成	秦煌
劉江	刘江
牛肉碎	刘玉翠
二叔	骆应钧
骆sir	骆应钧
应棍	骆应钧
麦包	麦长青
潘翁	潘志文
严慧明	雪梨
马芮	马德华
王野同	王伯昭
宋钟浩	宋宗浩
宋宗虎	宋宗浩
曹雪	曹曦文
林展平	林保怡
井宝	井柏然
然然	井柏然
戚慧	黑妹
董晶	董勇
萧剑	肖剑
莫小贝	王莎莎
安吉的爹	沙溢
刘冠霖	刘冠麟
陈万宁	宁财神
嘉颖	郑嘉颖
陈瑞	陈燃
茂伯	林宗仁
范佑臣	范逸臣
林纳斯	范逸臣
鳳小岳	凤小岳
黄建玮	黄健玮
萨仁娜	萨日娜
天水生	富大龙
枕云子	富大龙
唐波	唐以诺
张永刚	黑子
李力	李宗翰
安占军	安战军
吴亥	吴军
法图麦	贾晓晨
张毅	张译
小太爷	张译
陈思成	陈思诚
橙子	陈思诚
吴兆棠	吴卓羲
雪姨	王琳
高泓贤	高鑫
高欣	高鑫
高炘	高鑫
徐路	徐露
谭王子	谭涛
帅气教主	谭涛
小宝玉	谭涛
郭彦君	郭采洁
王文俊（本名）	文隽
文雋	文隽
倩倩	邬倩倩
赵晓刚	尤小刚
小张曼玉	牛萌萌
潘宛卿	潘迪华
刚仔	吴刚
金范	金汎
金泛	金汎
金尚泛	金汎
范儿	金汎
小范	金汎
范范	金汎
依萌	金依萌
李守海	李丁
小帅虎	陈志朋
朴时厚	朴施厚
朴平浩	朴施厚
陶惠敏	陶慧敏
宪哥	吴宗宪
本土天王	吴宗宪
姜鸿波	姜宏波
姜易宏	姜宏波
果静林	果靖霖
果静临	果靖霖
大宋佳	宋佳
徐涛	徐韬
宋中基	宋仲基
宋重基	宋仲基
宋忠基	宋仲基
花仲基	宋仲基
校草	宋仲基
酱油哥哥	宋仲基
花儒生	宋仲基
小宋同学	宋仲基
兔斯基	宋仲基
积极仲基	宋仲基
头脑仲基	宋仲基
平衡达人	宋仲基
神探仲基	宋仲基
名侦探仲基	宋仲基
参谋仲基	宋仲基
智囊仲基	宋仲基
宋钟基	宋仲基
言言	何琢言
郁英霞	郁可唯
小郁	郁可唯
郁闷墩儿	郁可唯
郁小兔	郁可唯
祥仔	阮兆祥
维塔利·弗拉达索维奇·格拉乔夫	维塔斯
凯蒂·麦格拉思	凯蒂·麦克格雷斯
凯蒂·麦格拉	凯蒂·麦克格雷斯
皇姐	凯蒂·麦克格雷斯
K姐	凯蒂·麦克格雷斯
马绍骅	马少骅
马少华	马少骅
洪小玲	洪小铃
乔纳森·考斯瑞德	曹操
宫内ひとみ（本名）	樱庭奈奈美
左小清	左小青
筷子肖	肖央
肖桑	肖央
王筷筷	王太利
筷子老王	王太利
麦嘉尚	麦嘉
光头佬	麦嘉
光头神探	麦嘉
白薇	金雅琴
李瑞琴	李香琴
小综	郑元畅
胖子	郑元畅
八爷	袁和平
方枪枪	董博文
三脚猫	董博文
毛儿	董博文
猫儿	董博文
张小童	张嘉译
以德服人	陈松勇
林绵禄	林扬
博慧	刘艺
鲁分	刘艺
白英	白鹰
灘叔、海灘	邹凯光
谢尔盖·德瓦茨沃伊	谢尔盖·德沃尔采沃伊
谢尔盖·德沃兹弗依	谢尔盖·德沃尔采沃伊
谢尔盖·德瓦茨沃依	谢尔盖·德沃尔采沃伊
谢怀复	谢芳
梅梅	梅峰
梅先生	梅峰
陈采岚	陈少霞
周楚楚	周楚濋
邹爽	邹俊百
韩健	雪村
师兄	刘浩龙
阿龙	刘浩龙
容生	刘浩龙
李白	李碧华
费洋	费振翔
费阳	费振翔
费贺楠	费振翔
尹释一	尹治
李尊杰	恭硕良
李祖伦	恭硕良
扎扎	热依扎
热依扎·阿里木江	热依扎
佀海岩	海岩
苏见信	信
徐秀琳	徐秀林
黄珏	黄觉
杜鹏	杜家毅
吴玟静	安以轩
红茶街公主	安以轩
林仔仔	林辰唏
林宛儒	林辰唏
濮树	朴树
郑龙和	郑容和
郑勇华	郑容和
郑龙华	郑容和
郑荣和	郑容和
姚婧	姚芊羽
彭晖	彭心宜
韩塞	韩寒
国民岳父	韩寒
刘美希	刘冰玥
刘希媛	刘冰玥
阿布	炎亚纶
吴庚霖	炎亚纶
表哥	曹查理
潇子珊	边潇潇
雄头	陈锦鸿
渡边夏菜	夏菜
莫小奇	莫小棋
莫麒	莫小棋
王萌萌	莫小棋
王萌	莫小棋
戴皎倩	戴娇倩
严惠玲	米雪
曾荣江	曾江
曾贯一	曾江
歆歆	张歆艺
二姐	张歆艺
歆兔	张歆艺
歆宝	张歆艺
马娅舒	马雅舒
小雅	马雅舒
丫丫	马雅舒
朱磊	朱泳腾
朱永腾	朱泳腾
崔胜贤	崔胜铉
基哥	李兆基
阿伯	黄镫辉
辉辉	黄镫辉
抗韩英雄	黄镫辉
金宝	金士杰
佳子	刘冠翔
闷罐	刘冠翔
刘佳	刘冠翔
潘丹霜	潘霜霜
黄美琪	黄美棋
九头身“花美男”.	郭品超
王俊美	王鸥
四哥	施柏鹏
吴瑰岸	吴岱融
陆建民	陆剑民
赵琳	赵子琪
白雪	白百何
宫俪轩	宫晓瑄
宫筱煊	宫晓瑄
宫主	宫晓瑄
宫筱轩	宫晓瑄
宫小萱	宫晓瑄
宫晓轩	宫晓瑄
王兰	王澜
陈东	白冰
白小冰	白冰
冰冰	白冰
小金喜善	白冰
吴竟	吴竞
吴静	吴竞
陶帅	陶灏景
桃儿酱	陶灏景
刘建光	刘小光
刘晓光	刘小光
小港	李仁港
包子	付辛博
磊磊	付辛博
付哥	付辛博
關禮傑	关礼杰
叶赫那拉·声威	那威
吴玉寿	吴廷烨
吴庭烨	吴廷烨
王巍	巍子
金基范	金起范
包子	金起范
贵族金	金起范
鸡饭	金起范
白雪公主	金起范
杨莲桂	程可为
赵小刀	赵丽颖
陈荣基	陈荣峻
阿甘	刘晓光
林申	林雨申
尼坤	尼查坤·抔勒威查固
尼琨	尼查坤·抔勒威查固
来笑声	赖晓生
陆永权	陆永
农夫组合	陆永
萧矛	肖矛
阎学晶	闫学晶
高锦	高峰
珊珊、女神	文咏珊
陈后俊	陈楚河
陈小宝	陈楚河
刘洋	刘名洋
阿照	尹天照
飞叔	王志飞
深水君	王志飞
鞅君	王志飞
郑小宁	郑晓宁
女周星驰	张庭
张淑琴	张庭
师父	聂远
少男杀手	江若琳
陈振华	陈司翰
冯威	冯绍峰
李梁	李泓良
李樑	李泓良
温昇豪	温升豪
叶缨	叶大鹰
丫丫	佟丽娅
小郑爽	郑爽
大郑爽	郑爽
小鬼	黄鸿升
田明慧	田蕊妮
昵名：雯雯	王黎雯
郑瑞晓	郑国霖
郑乙霖	郑国霖
锅子	郑国霖
蒋凯	蒋恺
黄明	黄宥明
阿信	陈信宏
张学景	牛犇
牛彝	牛犇
肖婕	肖聪
韩幼止	韩非
张建新	张子健
张子建	张子健
张健新	张子健
小米	乔任梁
梁梁	乔任梁
晴天娃娃	乔任梁
陶蕊	夏梓桐
周伟童	周韦彤
周娜	周韦彤
杨锐	杨奇雨
杨琦雨	杨奇雨
威廉	陈伟霆
等等	陈伟霆
向展平	向佐
鄢颇	鄢钷
鄢泼	鄢钷
王双保	王双宝
赵彦国	赵燕国彰
萧秀霞	萧蔷
吴汝忠	吴承恩
罗本	罗贯中
德如BB	朱慧敏
樊奕敏	樊亦敏
岑岑	侯佩岑
杨钫涵	杨紫嫣
杨雅娜	杨紫嫣
杨梓嫣	杨紫嫣
温玄烨	小小彬
吕品	毛毛
丫蛋	毛毛
史建全	史健全
邬桑	邬逸聪
宇崎逸聪	邬逸聪
关双双	关晓彤
张燕	张馨予
燕燕	张馨予
森吉德玛	咏梅
魏忠万	魏宗万
木江	张建亚
潘慧筠	潘慧如
雪雪	韩雪
雪小宁	韩雪
雪姐	韩雪
张磊	张正阳
老何	尚雯婕
尚三	尚雯婕
嘟脸版张柏芝	蔡颖恩
范智博	范志博
范志菱	范志博
亮亮	贾乃亮
卢克·埃文斯	卢克·伊万斯
刘云	刘芸
小吴彦祖	何建泽
张笛	张镝
张迪	张镝
刘欣	刘雅瑟
咕噜	罗晋
克里斯托夫·迈考利	克里斯托弗·麦奎里
安炳基	安兵基
乔安妮·巴伦	乔安娜·巴隆
陳毅	陈会毅
陳會勤	陈会毅
陈永煜	陈勋奇
陈健忠	陈建忠
陈建中	陈建忠
陈旻佑	陈建忠
程冬儿	程小东
邱戴安平	邱刚健
戴安平	邱刚健
秋水长安	邱刚健
耶律楚材	邱刚健
克里斯汀·崔	崔明慧
张石华	石隽
李勤益	秦天南
秦洗心	秦天南
鍾繼昌	钟继昌
埃里克森·科尔	埃里克松·科尔
玛莉亚	玛利亚
玛俐亚	玛利亚
肥妈	玛利亚
崔龄燕	崔燕
丁艺	丁一
馮源	冯克安
馮堅	冯克安
克仔	冯克安
克莱·多纳休·丰特诺	克莱·方特诺特
胡升忠	胡升忠
夏刚	夏钢
丹尼·戈登	丹尼·高顿
顾宝名	顾宝明
顾宝民	顾宝明
顾保民	顾宝明
胡诗学	古月
郭珂宇	郭柯宇
何一	何建军
何碧雯	岸西
侯勇	侯咏
胡柄榴	胡炳榴
许诚毅	许诚毅
许峻毫	许峻豪
许俊浩	许峻豪
许俊豪	许峻豪
萬仁	万仁
句兆杰	句号
赵军	赵君
江国民	姜国民
姜国文	姜国民
殷元奎（本名）	元奎
关铭觉	关海山
关宁	关海山
虾叔	关海山
林杞陶	林纪陶
林敏聪	林敏骢
林健明	林建明
李尚义	李炜尚
李敏仪	李敏
李载汉	李宰汉
大卫·里奇	大卫·雷奇
李强	李易祥
陆筱琳	陆弈静
陆奕静	陆弈静
吕小禾	吕晓禾
晓禾	吕晓禾
李建民	龙方
闵秉勋	闵丙勋
闵炳勋	闵丙勋
潘彧	潘予
潘美珠	潘予
阿琪·潘雅碧	雅奇·潘嘉比
鲍起鸣	鲍德熹
倪小雁	邵音音
奈尔森·辛	尼尔森·申
叶雨蒙	宋国勋
施楊平	施扬平
施揚本	施扬平
阿Ming	邓洁明
鄧潔明	邓洁明
邓荣銾	邓荣汞
丁子俊	丁子峻
曾谨昌	曾瑾昌
傻标，彪哥	黄光亮
黄启宇	黄一飞
大师兄铁头功	黄一飞
胡大為	胡大为
果子	徐耿
颜学庶	颜学恕
杨荔娜	杨荔钠
杨天乙	杨荔钠
电影诗人（美誉）	丁荫楠
尤勇智	尤勇
余德缨	余安安
袁承义	袁苑
袁长仁	袁祥仁
张扬	张杨
张卫平	张伟平
竹子	魏杨青
朱雯	朱文
德容	谌容
大卫·班尼欧夫	戴维·贝尼奥夫
纪延华	张笑天
纪华	张笑天
严东华	张笑天
金晟灏	金成浩
古佬	古明华
苏基	古明华
包租婆	元秋
李齐	李仁堂
刘文志	刘文治
王军政	王君正
乔什·盖德	乔什·加德
李铁生	李准
李准	李准
木华梨	李准
李凖	李准
于壹善	欧宜善
鱼一善	欧宜善
苏小卫	思芜
秋实	思芜
金荣华	金容华
大地	原岛大地
乔治·古提雷兹	豪尔赫·R·古铁雷斯
梅西·马利克	梅西·麦克利
乔·卡萨德	龙子乔
达娜·贾克赛·古瑞拉	丹娜·奎里拉
达娜·古瑞拉	丹娜·奎里拉
多布吉	多布杰
蒲燕利	浦蒲
钟志行	钟智行
陈谨	陈瑾
阿列克谢·费多尔琴科	阿列克谢·费多尔琴科
阿隆·汤尼	艾伦·托尼
陈百玲	小香玉
苏妍心	苏岩
苏妍	苏岩
曹瑞原	曹瑞原
马晓颖	马俪文
陆云卿	陆柱国
露西·克里斯塔贝尔·宝通	露西·宝通
邱黎宽	邱瓈宽
赫拉·希玛什多特	海拉·西尔玛
苍耳	王兴东
妮可·贝海尔	妮可·贝哈瑞
纳丹·帕克	内森·帕克
宝贝，马修	蔡志强
陈大飞	陈匡荣
大飞	陈匡荣
许韶洋	许绍洋
高亮	高宏亮
王子	邱胜翊
李志伟	李天翔
辛瑞娜	邢爱娜
德木阿果	何洁
梁镜珂	景珂
林朝章	明道
李晓枫	李昕芸
李昕云	李昕芸
刘虎	刘晓虎
李彤	李芯逸
炮哥	焦俊艳
小呆	唐禹哲
阿利森·麦卡蒂（本名） 艾丽珊 麦卡蒂（本名）AM 御姐 酒窝美女（昵称）	爱丽珊·麦卡蒂
刘晓梅	谢雨欣
王君如	王心凌
小众	曹众
曹三人	曹众
娅子	娅子
天然	冉红
擎硕	冉红
冉奶奶	冉红
冉奶	冉红
杨子珊	杨子姗
苏翠玉	桑妮
张大宝	张含韵
张小花	张含韵
古陈明真	陈明真
湘湘	李湘
汪建刚	汪涵
雷子	雷佳音
薛家彦	薛家燕
家燕姐	薛家燕
家燕媽媽	薛家燕
好姨	薛家燕
海丽·斯坦菲尔德	海莉·斯坦菲尔德
海莉·斯汀菲尔德	海莉·斯坦菲尔德
王垚	胤祥
朱东花	朱丹
连联	连奕名
张嘉年	太保
于淼	于是之
何味奇	何晟铭
何敏	何晟铭
吴海	石凉
连伟健	连晋
连伟建	连晋
徐安芸	徐艺玲
周存礼	村里
炅炅	何炅
何老师	何炅
张益达	李佳航
艾萨米勒	埃兹拉·米勒
悟泽·蒲巴甲	蒲巴甲
万人迷	万思维
吕睿喜	吕一丁
矮大紧	高晓松
多姆纳尔·格利森	多姆纳尔·格里森
多姆奈尔·格里森	多姆纳尔·格里森
谢刚	谢钢
伯鸿	田汉
陈瑜	田汉
漱人	田汉
汉仙	田汉
大V	梁大维
徐垚	徐海乔
媛媛	程媛媛
袁耀发	袁子皓
刘颖	颖儿
王越	王浩燃
吴振宇	吴振天
姚建国	姚二嘎
洪兴宇	文兴宇
吕京	吕凉
林菀	林芮西
王润森（原名）	蓝天野
陈玫璇	陈妍希
吴荫	常蓝天
宗晴	常蓝天
常兰天	常蓝天
李凌伶	李欣凌
白白	白歆惠
林依伦	林依轮
柏含	柏寒
井冈山	景岗山
鍾紹圖	钟绍图
诗雅	卫诗雅
吴伟男	吴浩康
宋宁	宋宁峰
谦仔	罗仲谦
凯瑞·贝里·布罗根	郝凯瑞
凯瑞	郝凯瑞
马克·罗斯韦尔	大山
路士伟	大山
疯耗子	王亚彬
张萌	张檬
楼安琪	馨子
帕纳伊特·玛丽亚	玛利娅
高树光	高曙光
张治坚	张志坚
戈治钧	戈治均
戈治军	戈治均
罗京明	罗京民
粉红猪	钟欣凌
蓝菲琳	金莎
李光富	李光复
周正芳	方芳
张翼平	张冀平
小薰	黄瀞怡
谢昀杉	叮当
谢冰钰	叮当
谢均杉	叮当
小叮当	叮当
石头	石锦航
猫耳宝贝	蒋璐霞
张林	张博
胡宇崴	胡宇威
王心如	王乐妍
鬼鬼	吴映洁
兔子	张雁名
岳耀利	岳跃利
党昊	党浩予
瑶瑶	郭书瑶
书瑶	郭书瑶
小瑶	郭书瑶
钟晴	钟澍佳
乔紫荷	乔乔
蒙克·巴特尔,大巴	巴特尔
罗定伟	侧田
阿田	侧田
陳嘉樺	陈嘉桦
祖峰	祖锋
佳佳	徐佳
严宽	严屹宽
宽哥	严屹宽
宽仔	严屹宽
小雄	中泉英雄
陶蓉	陶飞霏
龚施茜	龚慈恩
公仔	龚慈恩
張同祖	张同祖
王为卫	王蓝淇
刘绍铭	刘兆铭
严晓萍	严晓频
顔晓频	严晓频
王诗櫆	王诗槐
吴克羣	吴克群
胡继修	胡枫
史敏	史依弘
苗洛依	陶珞依
和和	于和伟
皇叔	于和伟
主公	于和伟
于叔	于和伟
邹梦月	某小丫
徐正希	徐正溪
王惠	杨光
阳光	杨光
第四维	郭敬明
小四	郭敬明
李海娜	苏查拉·玛娜英
苏莎·玛娜英	苏查拉·玛娜英
奥密兹·苏查拉特	苏查拉·玛娜英
苏小湃	苏查拉·玛娜英
楠楠	谢楠
大宝	谢楠
黄小宝	黄子珈
黄丽斯（曾用名）	黄子珈
黄丽思（曾用名）	黄子珈
笛子	姚笛
娄宵宵	娄艺潇
王慧娟	涓子
何耀深	高雄
林琛	高雄
黛儿·迪基	戴尔·迪奇
林暐淏	林伟
林兆伟	林伟
林鍏	林伟
康李	黎烈弓
李京京	李菁菁
小太阳	金世佳
孙翱	孙艺洲
金铭	李金铭
铭铭	李金铭
Lisa榕	榕榕
王冠	榕榕
武谊蓁	昆凌
曹啟泰	曹启泰
陈丽梅	陈思思
宇菲	张宇菲
麦子	安乙荞
杨荞安	安乙荞
霍曦泥	霍泥芳
卢卡斯·奈夫	卢卡斯·内夫
戴飞	唐缺
乾爸	乾德门
包尔吉古德	乾德门
钱顾腾德门	乾德门
乾顾腾	乾德门
包尔吉古德·钱顾腾德门	乾德门
李菲	李菲儿
舒燕	舒砚
张航睿（原名）	张睿
小龙	陈奕龙
王驾麟	王翔弘
何大拿	何云伟
焦俊翔	焦刚
刘薇薇	刘威葳
余征	于正
王五福	王伍福
耿长军	浅野长英
策策（昵称）	王策
王志刚（曾用名）	王策
李宥霖	李立
小赵亮	赵亮
轻舞飞扬	高洋
夏仪	周奇奇
奇奇	周奇奇
林郁智	纳豆
王安琪	王力可
王艳娜	王瀛
杨旎奥	杨紫
小橋めぐみ	小桥惠
郭芳	郭凯敏
喋喋	李易峰
徐威信	艾威
好笑文	郝劭文
臭屁文	郝劭文
好色文	郝劭文
郝邵文	郝劭文
王鹤龙	肥龙
王贺龙	肥龙
丁志诚	丁志城
丁志成	丁志城
宥胜	王宥胜
王郁翔	王宥胜
沈绍裘	沈少裘
舒耀瑄	舒耀瑄
舒耀煊	舒耀瑄
舒耀宣	舒耀瑄
舒耀碹	舒耀瑄
王霞	王一楠
臣刚、刚子	杨臣刚
施艳飞	施予斐
噜娜	岛田瑠那
张唏临	张晞临
刘园媛	刘园园
刘圆圆	刘园园
尼古拉斯·怀特	尼古拉斯·莱特
邢宇菲	邢宇飞
歌洋	邢宇飞
刘小峰	刘小锋
吴越	吴樾
迟佳	迟嘉
李成儒	李诚儒
琼安·弗洛干	琼安·弗洛加特
前田知恵	前田知惠
雷雨	张雷雨
顾一凡	顾又铭
王心静	王思懿
梁翠萍	梁静茹
小咕	李志希
贝玛泽旺	李志希
琳恩	赖琳恩
陈耀辉	陈十三
高菱薇	高宝宝
八两金	叶竞生
叶子申	叶竞生
柳翰雅	阿雅
大7	刘羽琦
7宝	刘羽琦
邢妍	江易珈
燕青	刘彦卿
王泳茗	王挺
袁家怡	汤怡
陈洁	陈龙
俊哥	刘承俊
郭民富	郭锋
郭峰	郭锋
郭大侠	郭锋
杰克森·赫斯特	杰克逊·赫斯特
常鲁峰	常铖
常诚	常铖
杨小蕊	杨蕊
蕊蕊青儿	杨蕊
吴岱凝	吴晓敏
丸子	周泓
小新	林更新
海波	温海波
大王	王凯
凯凯王	王凯
莫诗妮	莫诗旎
滕华弢	滕华涛
赵哥	赵正平
潘娟	潘星谊
曲虹霓	曲栅栅
曲姗姗	曲栅栅
程鹏	程小挑
小挑程鹏	程小挑
王瑶	夏笳
刘怡彤	刘晓洁
徐心爱	徐信爱
徐新爱	徐信爱
赵纯阳	赵龙豪
赵春羊	赵龙豪
洋妞儿	李净洋
咪咪	王丹怡栗
吴彩南	吴毅将
高云祥	高云翔
胖子（昵称）	段国云
齐襄	齐欢
黄野	黄幻
龙妈	艾米莉亚·克拉克
徐伶和（本名）	杉野希妃
张哲秀	张哲洙
千丙哲	张哲洙
宋宝利	宋小宝
小徐克	徐克
楊延晉	杨延晋
孟尧	孟瑶
王毅	王小毅
范范	范玮琪
顽皮豹	范玮琪
堂主	范玮琪
时间	王光利
李烁	李依晓
英皇柏芝	蓝燕
小妖	蓝燕
柳渊	丁柳元
露丝	干露露
露儿	干露露
露露	干露露
欣欣	蒋欣
维尼	瞿友宁
王锦鹏	王千源
田小杰	田小洁
栗子姐	高露
洪爷	林子善
梁智強	梁智强
梁志强​​​​	梁智强
粱志强	梁智强
司徒卓漢	司徒卓汉
杰满	蒋能杰
刘嘉悦	刘添月
刘均	刘钧
王英	王霙
迟篷	迟蓬
理查德·曼登	理查德·麦登
拜隆·曼	文峰
涉谷天马	涩谷天马
迪伦·欧布莱恩	迪伦·奥布莱恩
涤纶	迪伦·奥布莱恩
罗伯托 卡努图	罗伯托·卡努图
小袁	袁成杰
罗钢	罗刚
郑友杰	郑有杰
梁淑慧	梁又琳
小黑	柯受良
王宁	王柠
大喜	金晨
沈羽倩	沈畅
张之华	张芝华
潘雨晨	潘雨辰
邓兆移（本名）	江毅
杜宁琳	杜宁林
王丁筑	张家瑜
卤水蛋	鲁振顺
刘延宾	刘流
赵宝乐	赵保乐
耿金发	耿军
王十三	王啸坤
谢友侦	猪哥亮
谢新达	猪哥亮
猪哥	猪哥亮
秀场天王	猪哥亮
秀场巨星	猪哥亮
雅琦	法提麦·雅琦
王雅琦	法提麦·雅琦
尚蓉	商蓉
张敏	凌元
蒋育臻	蒋家骏
蒋家俊	蒋家骏
杨柳	杨童舒
葛炮	葛平
炮叔	葛平
葛叔	葛平
冲浪王子	蔡昌宪
小崔	崔永元
吴溟苍	车保罗
侣皓喆	侣皓吉吉
侣萧	侣皓吉吉
佀萧	侣皓吉吉
鲍鲍	鲍蕾
卢新龙	卢庆辉
小米儿	米铁增
管杰	管晓杰
欢欢	赵奕欢
DQ女孩	赵奕欢
小李琳	李佳璘
李琳	李佳璘
李佳麟	李佳璘
万嘉综	万籁鸣
大万老	万籁鸣
吉姆·格兰特	李查德
李·恰尔德	李查德
李娃	李查德
方德海	方化
青青	苏青
苏苏	苏青
青儿	苏青
小不点	苏青
桃花	苏青
于咏琳	于珈若
李玛姬	李曼筠
英姿	刘怡君
刘一晗	刘一含
大头飞	许飞
黄志强、细龟、小龟	黄一山
张澍澍	张译文
夫仔	蒋劲夫
郝好庆子	郝好
乐仔	黄嘉乐
王爱之	王菀之
小牛	爱莉安娜·格兰德
赵健	赵英俊
潇洒哥	赵英俊
小毛	毛孩
张一	张宁益
钱麓安	钱枫
鸵鸟	钱枫
大头	钱枫
枫哥	钱枫
水晶	郑秀晶
忙內	郑秀晶
张超	张伦硕
余淼	余秋瑶
元庭	吴明才
李莉莉	李丽丽
张晓磊	张小磊
羽翘	雨侨
廖羽翘	雨侨
金尚中	金相中
金锡重	金相中
李镇彪	金相中
李振彪	金相中
如花	李健仁
纽扣	刘宸希
许玮宁	许玮甯
許瑋甯	许玮甯
茜宝	宋茜
茜茜	宋茜
小茜	宋茜
柯家凯	柯震东
艾茹	艾如
芝芝	夏如芝
老罗	罗永浩
罗胖子	罗永浩
陈宝莲	陈宝玲
毕延君	毕彦君
毕颜君	毕彦君
七七	潘时七
七仔	潘时七
小7	潘时七
本·.埃利奥特	本·艾略特
本·艾利略特	本·艾略特
艾什琳·叶尼	艾什琳恩·叶尼
查朗措	李桃
桃子	李桃
阿措	李桃
洗脚婢	石原夏织
廖福彬	几米
气壳	王劲松
吴卓翰	吴庆哲
从从	唐从圣
娜扎	古力娜扎
古力娜扎尔·拜合提亚尔	古力娜扎
古丽娜扎	古力娜扎
芭比娜	古力娜扎
叶小美	叶青
沐子	叶青
叶芝泛	叶青
张立军	张二
彼得·席格	彼得·西格尔
吴雪文	吴雪雯
华仔（昵称）刘福荣（本名）	李红旗
石小群	石筱群
陈致通	陈述
熊耀华	古龙
徐致菁	徐洁儿
徐婕儿	徐洁儿
安娜贝尔·沃丽丝	安娜贝拉·沃丽丝
品川佑	品川祐
练练	练束梅
庄濠全	敖犬
鄢小宇	侯彦西
鄢胜宇	侯彦西
杜娟	何杜娟
乔保罗	乔宝宝
托马斯·格兰特·古斯汀	格兰特·古斯汀
大头	倪妮
喵总	倪妮
二妮	倪妮
杜晓婷	杜若溪
艾志超	包贝尔
田啟文	田启文
田雞	田启文
于延江	于洋
纳仁巴特尔	于晓阳
董文娟	董克娜
卡蒂亚·温特	凯蒂娅·温特
苔莎·法米加，泰莎·法梅加	泰莎·法米加
巨塔	泰莎·法米加
李晟毓	李泰延
甜甜	陆子艺
英巴图	巴图
英如镔	巴图
何志峰	何明翰
常春晓	春晓
张姗姗	柏邦妮
阿刀（ 别名）， 阿杜（绰号）	杜宇航
青青	贾青
杜原	杜源
范玉林	范雨林
张志中	张志忠
王禹峻	王策
哈林	庾澄庆
小刚	唐振刚
胡人	胡雪杨
孔令馥	谢雪心
无敌小老鼠	吴建飞
茅志君	茅子俊
阿西	陈博正
徐才恨	徐才根
姜珉赫	姜敏赫
美秀	林美秀
张瑞涵	张希爱
阿莉·乔维尔	雅丽·乔维尔
阿赫丽·乔维尔	雅丽·乔维尔
杰瑞米·欧文	杰瑞米·艾文
番薯	张番番
甯元乖	鬼叔中
奇夢石	奇梦石
大慧儿	刘慧
古古·玛芭塔-劳	古古·姆巴塔-劳
胜东日	成东日
成东镒	成东日
东方小庭	胡小庭
戴阳天	戴向宇
阳阳	戴向宇
小戴	戴向宇
鲍晶晶	鲍鲸鲸
左小岸	谭华
赵蔚欣	赵硕之
徐智勇	小肥
音乐情人	郑子诚
岑立范	岑范
徐行	徐飒
叶新	叶祖新
少奶奶	孙宁
连弈琦	连奕琦
連奕琦 ​​​​	连奕琦
Gigi姐	黄淑仪
菜菜	马赛
李鹏	李东翰
陈家欣	泳儿
古小筝	古筝
周晓欧	周晓鸥
张松岩（本名）	张莹
陈涛	陈羽凡
安健	安建
李云鹃	李云娟
肖萌萌 肖少 旭旭 少爷	肖旭
尚韦伯	尚于博
晓彤	毛晓彤
彤宝	毛晓彤
房斌	房子斌
孙逸飞 孙鐿菲	孙艺菲
张立军	张立君
勾纯沅	勾峰
王伟男	王伟源
刚强	王刚强
王欣	王新
蕾拉·贝克缇	莱拉·贝蒂
陈蓉	蓉卓
陈亦然	蓉卓
曾子灵	曾美慧孜
曾美惠孜	曾美慧孜
蒋冰冰	蒋冰
刘小小	刘筱筱
祖丽晴	祖晴
邓淑文	邓玉婷
吴欣容	吴千语
蔡宜凌	蔡依林
马东延	马强
白雪嬅	白冰冰
白月娥	白冰冰
铃木啄也	铃木仁
屈菁箐	屈菁菁
符莹	阿朵
徐雅祺	徐百卉
李承铉	李承炫
徐皓峰	徐浩峰
阿纬	刘俊纬
刘君一	刘一君
武涛	俞白眉
任正彬	任正斌
铃木奈央	铃木美妃
点点	绪方义博
夏力心	夏力薪
夏立新	夏力薪
夏立薪	夏力薪
于惠	于慧
黄子恒	黄子桓
小黑	谈莉娜
凡妮莎·拜尔	瓦妮莎·贝尔
刘磊	刘冠成
邱敏敏	皮查雅·瓦塔那蒙迪里
豆豆	黄龄
细杰	洪智杰
季天生	季天笙
季威利	季天笙
蒙湘	蒙亭宜
独眼龙	程东
大军	程东
陈献栋	程东
张伟芬	鲁芬
宋运城	宋运成
吴炫	吴祯
叶倩云	叶一云
冯自力	冯自立
金毅	金亿
钱致	钱志
黄品冠	品冠
曹佰豪	曹格
王光良	光良
许浩宏	许榕真
杨忠熹	杨帆
小宝（艺名）	杨羽
齐中阳	齐中旸
齐婧	齐中旸
郭伯瑜	郭静
郭小静	郭静
克莱儿	郭静
郭同学	郭静
纯爱天后	郭静
纯爱教主	郭静
李心乐	李毓芬
乔乔	曾之乔
班班	曾之乔
花花	曾之乔
徐翠翠	徐梵溪
大B哥（外号）	吴志雄
孙权	孙佺
塔林托雅	塔琳托娅
托塔琳垭	塔琳托娅
田桂芝	田震
李爱军	李昊翰
刘薇	刘小微
王往（笔名）	王树忱
王树枕	王树忱
闫善春	阎善春
林林	林龙麒
李依蔓	李艳
祥子	侯祥
朱元	周元
文晙原	周元
林佳树	川岛茉树代
永健（昵称）	刘永健
鄂布斯·勇林	鄂布斯
鄂勇林	鄂布斯
唐荣澄	唐澄
唐清之	唐澄
萨姆·凯雷	山姆·基利
丽丽法兰	刘捷
逗逗	张逗逗
段宇华	华子
李敏	李佳璇
李敏诗	李佳璇
金佳	金珈
江洋	江明洋
盛上	盛鉴
鉴宝	盛鉴
老大	盛鉴
二档头	盛鉴
妙妙	缪婷茹
吉恩·伊莎贝尔·史密斯	吉恩·史密斯-卡梅隆
梁绍生	梁晓声
钱婷	钱哆多
钱多多	钱哆多
董立凡	董立范
董丽范	董立范
陸明君	陆明君
老土	杨真
余红艳	尔玛依娜
天仙妹妹	尔玛依娜
满意	巨兴茂
痞子	张炜迅
阿拉平平	翟天临
翟萌萌	翟天临
天临	翟天临
老大	翟天临
陈琦	陈奇
丛智军	丛志军
张锎伦	张一龙
张岩	张一龙
小陈思璇（昵称）	思漩
方一杯	方文山
刘锡铭	刘锡明
李源	李东学
巴音额日乐	巴音
巴音额日勒	巴音
阎青	阎青妤
朱厚仁	朱厚任
吴欣云	袁咏琳
李蕴洁	李玥
严敏求	严敏裘
大松鼠	王迅
邵思凡	邵斯凡
源立夏	源利华
宗晓君	宗晓军
陶子	陶晶莹
王岩	王思雅
全联先生	邱彦翔
王晓风	王晓
李信樵	金刚
罗彬	罗诠浩
雨不亭	周耀武
甜心	李欣汝
乔宇	乔鹏樾
张凡	斓曦
曾韵	曾泳醍
张晓涛	张晓龙
赤飞	韩赤飞
阿布日古（笔名）	韩赤飞
打胎狂魔	薛之谦
小妞，惠紫	路晨
宋艺宁	宋忆宁
国民弟弟	俞灏明
张本瑜	张本渝
姜涛	一真
阿部真理	矢吹春奈
阿部真理子	矢吹春奈
阿布真理	矢吹春奈
王子义	王紫逸
子义	王紫逸
瑶瑶	高姝瑶
王璟	王馨悦
简·莱维	简·拉维
欧汉声	欧弟
海顿	海顿
大塚匡将	大冢匡将
姜炜	姜凯阳
小斯琴高娃	斯琴高娃
南吉	斯琴高娃
麦迪娜·买买提	麦迪娜
牟春光	牟森
伊丽莎·库普	伊丽莎·库伯
杨芷菲	杨旸
坤达	谢坤达
胡小夏	胡夏
夏夏	胡夏
谢东	谢东燊
核桃（圈内人爱称）；河套（媳妇爱称）	何涛
蔡函岑	蔡芷纭
寒	蔡芷纭
王嘉佳	王佳佳
盛瓅伊	盛利
晶晶	盛利
王晖	王同辉
鸟哥	沈磊
矢島健一	矢岛健一
唐婷	唐艺昕
宁丹琳	丹琳
高小攀	高晓攀
李小妍	李妍憬
李妍瑾	李妍憬
凯特林·德弗	凯特琳·德弗
豆豆	潘延
德恩·戴哈恩	戴恩·德哈恩
戴涵涵	戴恩·德哈恩
岳龙刚	岳云鹏
小岳岳	岳云鹏
岳帅	岳云鹏
李翊玮（本名）	李威
拉拉	徐佳莹
白马公主	徐佳莹
星光才女	徐佳莹
唱作精灵	徐佳莹
赵福馀	赵福余
雷震语	雷镇语
钱石义	钱泳辰
阿妹	张惠妹
阿密特	张惠妹
古歷來·阿密特	张惠妹
蒋宜函	蒋竹青
于震环	于震寰
毛孩儿	于震寰
毛孩	于震寰
焯匀	田朴珺
少爷、赫少、赫队、赫爸、张先生、发箍男	张赫
杨安东	孟飞
冯靖贻	冯静
马蓉	马千珊
姚寿康	姚守岗
曾佩瑜	曾珮瑜
李鐘賢	李宗泫
梁鲁园	鲁园
杨露	杨曼琴
杨潞	杨曼琴
阿亮	卜学亮
瑞安·安东尼·古兹曼	瑞安·古兹曼
湛雅舒	湛雅书
苏秀珠	苏明明
章蓉舫	章小蕙
章瑄桐	章小蕙
叫兽	易小星
易振兴	易小星
叫兽易小星	易小星
蠢爸爸	易小星
叶子淇	叶熙祺
萨库拉	杨梅媛
张博翔	张宇
王宏文	班杰
姜浩文	姜皓文
姜汉文	姜皓文
林大川	林家川
高伟	高一玮
黑人	陈建州
加藤侑纪	郭侑纪
李铉在	李贤宰
李贤载	李贤宰
张勇	张小北
约翰·卫斯理·查塔姆、韦斯·查塔姆	约翰·威斯利·查特曼
秋枫	周康渝
郭法增	郭法曾
王莉芸	王丽云
高海燕	高瑜
余沥卿	于立清
侯传皋	侯传杲
宋凯	宋佳伦
宋加仑	宋佳伦
司光旻	司光敏
司珂华	司光敏
李沐晴	李艳冰
黄璧瑶	黄千格
徐飞廉	徐东生
曲翊宏	曲双双
凃凌	涂凌
朱泠谛	朱子岩
谭晶晶	谭松韵
仇世友	仇世有
小黑	仇世有
刘言语	刘泊潇
刘乐妍	刘乐妍
石仔	陈宇琛
尹晓洁	尹媗
伊晓洁	尹媗
布拉德·弗曼	布拉德·福尔曼
纳特·法克森	奈特·法松
章珺	章龄之
徐景（本名）	徐熙颜
马伦	马仑
扈强	扈耀之
何嘉仪	何佳怡
闫建刚	阎建钢
阎建刚	阎建钢
文龟	陈文贵
大秦子	秦卫东
张嘉佩	爱戴
张琰琰	张棪琰
张锦尧	张棪琰
潘耀武	潘泰名
张均涵	张钧涵
王洋	王雪洋
黄益承（本名）	安钧璨
柯有纶	柯有伦
吴晓丹	吴紫彤
洪林岭	洪紫琳
马子洛	马骏超
木拉丁·阿不力米提	木拉丁·阿不力米提
木拉丁	木拉丁·阿不力米提
李桓	卫仑
刘雯	刘思彤
李璐岑	李羲儿
张谊	张定涵
卫宁	毛卫宁
顏卓靈	颜卓灵
瞿万臣	翟万臣
翟万成	翟万臣
小陆（昵称）	陆玲
陆叶	陆昱霖
方美人	方泓仁
禇栓忠	褚栓忠
栓子	褚栓忠
李远	小野
马军镶	马军骧
朱玲	朱玟晞
吕夏葳	吕夏
刘德益	刘德一
花前说剑（笔名）	徐琦
左玲	左翎
张帅	张天其
张允帅	张天其
田振崴	田牧宸
吴姵文	简沛恩
孙伊茗	孙一明
刘晏辰	刘维
雷诺	雷诺儿
公方明	公方敏
金龟子	刘纯燕
盛京骏贝勒	佟骏
涂吉龙	狄威
屠龙	狄威
阮志强	阮惟新
如意（昵称）	齐如意
张宗瑞	张勇手
张永寿	张勇手
宋渡宇	宋歌
高厂	高峰
埃米·舒默	艾米·舒默
姚馨茜	姚星彤
姚岚	姚星彤
广源	马广源
柴欧	柴鸥
陶明喜	陶盟喜
刘晓烨	刘晓晔
蒋一萌	蒋一盟
王韵晰	王皓
王建	王健
刘安乔	刘圆媛
安乔	刘圆媛
张程	源唯杰
布斯	丁佳明
蔡盛	蔡珩
楷婷	陈语安
阿郎	张洲
张红兵	张楚
侯钧升	侯祥玲
刘闵涛	刘敏涛
小夏雨	夏雨
刘苏逸	刘莉莉
张含	张洪睿
雪米莉	谭力
沙利文	谭力
齐B小短裙	周蕊
善天	石爻
石丽玲	石爻
张筝	张铮
包公毅	包天笑
朗孙	包天笑
拈花	包天笑
小卿	刘文卿
奥娜·查普琳	奥娜·卓别林
安德鲁·兰内尔斯	安德鲁·兰内斯
竹灵	朱琳
王维	王子睿
李成	李岷城
辛蕾	辛芷蕾
安书炫	安瑞贤
安书贤	安瑞贤
东来东往	戴凌鹏
陈丽丽	陈廷嘉
大壮	赵泽文
丁莉	丁洋
祁潇潇	祁映诺
李柯竺	李佳
廉声	王连生
王廉生	王连生
须士川	须乾
须世川	须乾
阿囧	黄晋琨
谷涬仪	谷倖仪
谷倖仪	谷倖仪
王宜凌  王泳心	王彩桦
于竹馨	于莉
阎清	阎汶宣
莫合塔尔·铁列吾哈孜	莫合塔尔
喻维宏	喻瀚湫
咪咪	田晓威
刘扬帆	武艺
郑锦荣（原名）	郑祖
黄灿成	黄灿盛
熊灿	黄灿盛
黄将军	黄灿盛
黄巨人	黄灿盛
香蕉灿	黄灿盛
王泫尹	王泫伊
杨静如	杨净如
丁浩	丁宇辰
江南疯子	张江南
大铭子	李乾铭
居居	朱一龙
居老师	朱一龙
龙哥	朱一龙
欧丑丑	丑丑
张恕	张澍
胡允儿	吴靖萱
胡丹	吴靖萱
胡梦媛	吴靖萱
淇淇	王秋紫
于清斌	于青斌
金珠佐罗	左金珠
王宝才	王小宝
孙洪纺	孙羽
万瑶瑶	万美汐
蓝盈盈	蓝盈莹
索菲·特纳	苏菲·特纳
金子、大金子	曹云金
杜大偉	杜大伟
张然教	朱虎声
维罗·希尔兹	薇洛·西尔德斯
田逗	田娃
丽丽	马丽
宋柯欣	宋珂欣
艾莉丝	曾莉婷
爱丽丝	曾莉婷
王尹	王钧赫
大卫·艾亚	大卫·阿耶
雯姐（昵称）	张雯
曲戈	曲江涛
王奕权	王烈
少马爷	马志明
金泰旭	金正泰
吴嘉欣	方皓玟
龚茜彤	乐瞳
黄健龙	吕小龙
张伊明	张恩齐
刘家宝	刘钊
蒋本浒	麦家
李尚葉	李相烨
陈雨莳	陈佳妍
陈筱诺	陈佳妍
陈实	陈佳妍
小艾	敦婧怡
赵贲	赵犇
赵奔	赵犇
符馨尹	符荷晴
符美凤	符荷晴
光头仔	王嘉明
Mike隋	隋凯
安尼瓦尔·阿不拉伊提	艾尼瓦尔·阿不拉伊提
安尼瓦尔	艾尼瓦尔·阿不拉伊提
安东	邓安东
东哥	邓安东
傻逼	王川
蔡舒楠	蔡抒南
陈锦昌	陈汗
杨梓鹤	杨阳
冯璤	冯瓅
冯砾	冯瓅
冯粒	冯瓅
唐子成	唐棣
凯特·麦今郎	凯特·麦克金农
小安 安哥   小安安	是安
带三个表	王小峰
李敏	李馨雨
张彦明	张菲
阿牛	张菲
翟文斌	翟子陌
黑叔叔	陈晓卿
扫街嘴	陈晓卿
李希熙	李云迪
西尔扎提·牙合甫	西尔扎提·亚合甫
谢尔扎提·牙合甫	西尔扎提·亚合甫
龅牙珍	陈凯师
刘伯明	柏明
胡子男	柏明
左雯璐	左夏初
左百韬	左夏初
金沛晟	金沛辰
莫昌成	金沛辰
宋佳人	宋金笑
瑞贝尔·威尔森	蕾蓓尔·威尔森
徐凌雪	徐汶萱
闫兴雪	乌雅心颜
大同	方大同
大同宝宝	方大同
北极王子	方大同
方啾	方大同
小方	方大同
大同仔	方大同
卷卷头	方大同
方老板	方大同
赵笑明	赵晓明
圣马	马诗红
Hold住姐	谢依霖
李佩玲	丁宁
邹介三	邹承恩
洪正恩	洪静恩
洪贞恩	洪静恩
洪氏姐妹	洪静恩
朱繼屏	李璇
阿联	易建联
吴起焕	吴基焕
吴启焕	吴基焕
吴基桓	吴基焕
李向民	南柯
白骏	扎西顿珠
疯狗	雅彦·鲁伊安
狗叔	雅彦·鲁伊安
麥詠麟	麦咏麟
王婧娈	王安迪
戈春燕	戈春艳
葛春燕	戈春艳
金敬穆	金炅默
孙晓天	孙仲加
小九	孙仲加
杰西卡	郑秀妍
邓小峰	邓梓峰
邓十郎	邓梓峰
廷儿	区雪儿
马文龙	马敬涵
孙增田	孙曾田
米山峰夫	梦枕貘
宫晓	宫正楠
陈扬	陈乔希
唐婉	唐菀
张佳蓓	张龄心
吴炜	吴其江
曹迪生	曹建南
曹健南	曹建南
熙儿	莫熙儿
卢老师（昵称）	卢思思
梅丽娜	梅莉那
陈童菲	童菲
徐萌	艾尚真
鬼马小精灵（昵称）	徐麒雯
卡西（网名）	徐麒雯
张紫程	张旭
李准	李海洋
千面夏娃	孟茜
火龙小兽	刘可欣
乔诗雨	乔诗语
张杰	阿杰
邓筱溪	竹原青
丁咛	丁宁
柳仁英	刘仁英
彪叔	白彪
火鸟	刘序浩
虞晓卉	虞小卉
常景茹	常景如
昂昂炫道	曲瓅男
曲砾男	曲瓅男
曲立男	曲瓅男
李文兵	非行
甄柏荣	甄栢荣
康康	康晋荣
晨妮	邱箫婵
太后（昵称）	菁玮
强尼·史壮	强尼·斯特朗
乔·卢素	乔·罗素
欢子、欢哥、Happy哥	刘欢
陈士弘	陈冠霖
巴森扎布	巴森
孙刚	孔刚
许涯男	顾小白
宝宝	顾峥
小傅导（绰号）	傅天余
建平鸽，尖发杀手，主食韩国人，搏击吴彦祖，墨镜小天王,13亿分之一最强男	杨建平
杨俊平	杨骏
祖辉	周振辉
吕晓林	吕晓霖
张娜	张维娜
郑盛元	马国毕
于耘婕	于美人
檀兮尔	檀健次
里奇·韦伯	理查德·韦伯
熊雪妮	雪妮
妮姐	雪妮
张隽溢	张念骅
左大建	大左
贾致刚	贾致罡
贾志刚	贾致罡
虎子	陆虎
任斯璐	任珈锐
鱼儿blanda  人鱼公主 小鱼儿 人鱼歌姬	孙敬媛
聪聪	赵聪
老六	张立宪
孙杰	作业本
孔祥照	孔二狗
武相梅	向梅
杜长蕊	杜沁怡
姚懿纯	姚懿宸
姚郑夷	姚懿宸
昆文扎尼·瓦里斯	奎文赞妮·瓦利斯
张惠中	张会忠
港版leah dizon	陈静仪
马泰	马志
卢婉茵	卢宛茵
米粒	徐立
祝捷	祝雨辛
伊凡威	王俊棠
棠叔	王俊棠
阿Cat （昵称）	周家怡
章萍	章雯淇
章西西	章雯淇
金圭莞	金圭烷
金圭浣	金圭烷
两蚊	邵丽琼
二员	邵丽琼
吕嘉民	姜戎
陆一同	陆一铜
小絮（昵称）	张诗絮
金希沅	金熙元
瑄瑄	王智
紫瑄	王智
紫紫	王智
王紫瑄	王智
宁子	郑宁
让·米歇尔·卡萨诺瓦	马今
郑敬和	郑京虎
郑京浩	郑京虎
郑京宝	郑京虎
胡小光	胡晓光
许玉军	来喜
约翰·贾丁斯	约翰·盖汀斯
童忠贵	苏童
苏茜薇	苏倩薇
Mary姐	韩马利
金炯俊	金亨俊
阿戟	蔡明丽
班戟	蔡明丽
歪马	王云飞
董易晋	董春辉
董敖岩	董春辉
张御姐（昵称）	张玉洁
张鱼（网名）	张玉洁
陈晴漪	陈婷
朦朦（昵称）	胡桑
陈会龙（本名）	陈龙
小雅	顾莉雅
安东尼·卢素	安东尼·罗素
夏雨乔	夏于乔
乔乔	夏于乔
乔妹	夏于乔
夏郁乔	夏于乔
杨瀚	杨世瀚
大眼	李承鹏
钱远达	钱运达
范蕾颖	范楚绒
阿范	范楚绒
萧嘉荣	萧荣
肖荣	萧荣
萧容	萧荣
欢哥	刘欢
博华	陈丽华
于立桄	于晓光
郑功宇	乌青
小5	张宁江
小舒淇	林佳陵
金玄哲	金贤哲
叶新晨	叶青青
李虎成	李虎城
章鑫	章宇
酱爆	何文辉
武雪	武笑羽
章馨心	章艳敏
张馨心	章艳敏
宋本忠	宋本中
付程鹏	傅程鹏
猫猫	林伊婷
伊丽莎白·德比齐	伊丽莎白·德比茨基
张瑾	张瑞珈
张煜佳	张瑞珈
鲍海明	鲍海鸣
王箐华	王菁华
郑亦桐	郑逸桐
亚当·德利弗	亚当·德赖弗
夏志清	夏志卿
申泰罗	申太罗
王海林	汪海林
小帥哥	沈玉琳
花爷	花昆
花騉	花昆
花骏纶	花昆
邓卫	邓为
黄振隆 （原名）	黄玉郎
李纯	李沁谣
纯纯	李沁谣
士巴拿	冯勉恒
王立新	王择谚
孔文娟	孔宋今
孔千千	孔宋今
小亮、影视剧歌王	王铮亮
阿孜古丽	阿孜古丽·热西提
小猫	钟欣怡
小甜甜	钟欣怡
锺欣怡	钟欣怡
董董	董董
布莱克·亚历山大·詹纳	布莱克·詹纳
科迪.艾伦.克里斯蒂安	科迪·克里斯蒂安
柯迪.克里斯汀	科迪·克里斯蒂安
科迪.艾伦.克里斯汀	科迪·克里斯蒂安
吴妍书	吴涟序
吴妍瑞	吴涟序
吴寒妮	吴涟序
草原哈琳	哈琳
刘鹏杰	刘杰
朋哥	刘杰
李家荣	火火
汉娜·薇儿	汉娜·韦尔
张瑛	张英
钱学恪	钱学格
杨志伟	杨浩然
尚玟熹	尚华
三郎	李奇龙
释德强	李奇龙
王玲	王灵
邵慧明	邵思涵
萧璜	于力
高蓉	高榕
农夫组合	郑诗君
C君	郑诗君
牛俊锋	牛骏峰
梁立	梁丽
刘岷	刘奕君
刘曼逸	刘淼
赵斌	赵擎
姚小帅	姚奕辰
张宝文	张宝雯
刘奕丹	刘芷汐
叶可儿	叶梓棠
杨君（本名）	杨子骅
墨娃	刘婷
陈兵	斌子
王菲	飞儿
武术王菲	飞儿
王缨灏	飞儿
尚忠龙	尚国伟
张欣	张鑫
亦星	张鑫
贺亮	亮子
胡乔华	华少
秦文	秦雯
罗福	罗灿然
夏凡霓	夏一瑶
夏冰冰	夏一瑶
小叶子	韩烨
范建会	范建浍
高峰	高子沣
龚英田	龚应恬
龚英细	龚应恬
藏希	臧希
藏西	臧希
藏里	臧里
马丹妮	马丹旎
韩德军	韩三明
冼志偉	冼志伟
肖锋	萧锋
张慧中	张惠中
校园王子	童安格
王玉章	王玉璋
小脆、段公子	段黄巍
小王晶	王晶
轩南	张轩南
原子霏	原梓霏
蔡威力	蔡维利
温玄煜	迷你彬
王洋	王阳
邹采琳	邹娜
程逝寒	程思寒
大狼	程思寒
酷哥	谭皓
季裕哲	季晨
丹妮公主	王李丹妮
小猫	王李丹妮
巫女	王李丹妮
寒小七	王李丹妮
女王	王李丹妮
王李丹	王李丹妮
马育红	马玉红
孙瀚文	孙翰文
水鱼	黄翠如
啷啷	黄翠如
利亚姆·詹姆斯·佩恩	利亚姆·佩恩
莉莉	利亚姆·佩恩
柳盛元	柳建伟
郑丽贞	秋婷
莲华	陈曦
刘颖	刘雨鑫
谭晓燕	谭小燕
白微	白威
小宝	成毅
磁淇	徐仁国
怪咖	袁晓超
稽少宣	嵇波
辉哥（昵称）	许杰辉
良良	王良
小良	王良
樊珲	樊昊仑
董丽丹	董艺薇
潘峰	潘镜丞
梅格·钱伯斯·斯蒂德尔	梅格·钱伯斯·斯蒂德尔
张鱼旦（昵称）	张鲁一
张熙	张芷溪
麦小琪	江疏影
麦晓琪	江疏影
苗海忠	苗皓钧
阿苗	苗皓钧
祥子	王兆祥
扎鲁楚特·哈丹·巴特	陶为
刘冬	刘腾远
李源丰	李柏谊
袁放	袁新
杨沫	杨梓墨
张宏娜	张译木
姜宇清	姜雯
谭杰希	谭佑铭
阿希	谭佑铭
杜小米	杜雨辰
刘志强	文杰
王聃葳	柏安
王丹薇	柏安
赫兰鹏	赫子铭
小林浩	林浩
浩子	林浩
浩浩	林浩
多哇才吉	多哇·才吉
孙田俐姿	孙田莉子
孙田莉姿	孙田莉子
赵璁	赵禹晴
赵佳音	赵禹晴
李海铭	李广斌
张弦子	弦子
廖婧伶	安心亚
戴芸忆	戴云霞
米紫安	陆怡璇
陆昱颉	陆怡璇
陈大伟	陈牧扬
温健婷	温心
婷子	温心
管谟业	莫言
瑞奇·莫尔	瑞奇·摩尔
里奇·摩尔	瑞奇·摩尔
钟英奎	钟英魁
董成鹏	大鹏
雷鸣	雷明
王思杰	王陖
陈宝辕	陈保元
蔡意	蔡宜达
邹志俐	邹笨笨
雷珍萍	阿幼朵
粉丝尊称：四哥	野营
小六	孙斌
小6	孙斌
舜子	许效舜
戴小龙	小沈龙
涓涓	宋祖儿
孙凡清	宋祖儿
黄祎琳	黄一琳
瑟丝丽·思聪	塞西莉·斯特朗
温兆宇	小彬彬
张晗	张涵晰
哈吉·阿卜杜勒·阿齐兹	李龙吟
高永安	高天红
章文萱	章婷婷
章靖宜	章婷婷
王丰圭	王凤奎
罗娜· 韦斯贝克尔	白露娜
韦罗娜	白露娜
王艺婵	王艺禅
杨国华	过华
吴沅仪	吴浣仪
吴婉仪	吴浣仪
张太佑	张太维
张太侑	张太维
雷涌	上官醉
郑婧妍	郑岚侨
岗子	邓钢
丫丫	魏一
金正花	金贞花
金贞华	金贞花
金正华	金贞花
韦国清	韦国春
孟祥丽	孟庭丽
洪都拉斯	洪胜德
宏都拉斯	洪胜德
王离	王黎
张海	张煊赫
舒昌格	舒适
周媛媛	周木杨
柳飞·华	华本度
贾乃亮失散多年的亲兄弟	郭晓然
郝阳	郝洋
陳麗英	陈丽英
王飞	王飞飞
彭奕裔	伊一
廖春梅	梅芳
洪子涵	安唯绫
开坦克的贝吉塔	李阳
陈果	陈楚翰
侯角	侯璎珏
侯冰	侯璎珏
迪丽热巴·迪力木拉提	迪丽热巴
基纳·格兰尼斯	吉娜·格莱尼斯
毛林颖	毛林林
章颉	章劼
邵锴	邵桐
田璐函	田璐菡
张宏亮	张津赫
郑焱今	郑敏
大腮帮子	郑福山
阿傅（昵称）	傅靖生
潇洒哥	韩梓轩
小白	白凯南
汤姆·霍兰德	汤姆·赫兰德
荷兰弟	汤姆·赫兰德
刘小惠	刘小蕙
郭星宏	郭鑫
朱芷玄	芷玄
悟空妹	芷玄
杨海峰	啸杨
经纬	涂经纬
赵园	赵圆瑗
赵圆圆	赵圆瑗
松原	萧松原
萧兵	萧松原
美洋洋	杨菲洋
杨洋	杨菲洋
毕任相	林深
小宝（小名）	王一鸣
夏钦	夏菁
李沁霖	李进荣
李霖	李进荣
梦溪	张蒙晰
衣柜人	韩丹彤
衣柜姐	韩丹彤
韩主任	韩丹彤
赵旭	赵楚纶
赵楚仑	赵楚纶
谭郎昌	谭朗昌
亚当·德维恩	亚当·德维尼
赞达亚·科尔曼	赞达亚
千黛娅	赞达亚
邱东华(本名）	邱处机
徐亮	徐德亮
林翊瑄	林筱筠
苏里佟佳诗	佟童
恩潋	佟童
小何晴	何晴
郝健	沈腾
李明	自由极光
刘露	刘校妤
刘校姝	刘校妤
李梅	李梅可
莫轩	莫绮雯
洪伟	红心
刘睿	刘柏廷
超超	张超
崔小倩	崔倩
梁琳琳	梁林琳
蒂莫西·查拉梅	蒂莫西·柴勒梅德
蒂莫西·夏拉梅	蒂莫西·柴勒梅德
提莫西·查拉梅	蒂莫西·柴勒梅德
堤摩西·柴勒梅德	蒂莫西·柴勒梅德
蒂莫西·沙勒梅	蒂莫西·柴勒梅德
甜茶	蒂莫西·柴勒梅德
莎乐美	蒂莫西·柴勒梅德
小美	蒂莫西·柴勒梅德
布兰顿·思怀兹	布伦顿·思韦茨
宋小宇	宋晓宇
王晓明	王建福
黄品沅	黄若萌
孙金良	金粮
杰克·雷纳	杰克·莱诺
卡抽	卡拉·迪瓦伊
凯瑞·沃尔格伦	凯瑞·华格伦
老毕	毕福剑
毕姥爷	毕福剑
孙侨潞	孙圳
王思芸	王小挺
王华圳昱	王小挺
吴红巾	左小祖咒
盛君	夏嫣
张华鑫	张然
洪一平	洪亦平
张路	张鹭
李华	李鑫雨
周彦宏	周艳泓
大炮	胡海泉
启航	亓航
白洁	白柳汐
弹头（绰号）	宋健彰
人品差	强小陆
郭郁滨	郭家豪
葛欣	葛玟希
宦勇	宦普凡
王强新	文祥
修哥	修睿
修大侠	修睿
汪亚朝	汪汐潮
赵毅	赵汉唐
杰瑞米·洛夫林	杰里米·洛夫林
陈谦	应岱臻
长江	李长江
虞美娜	虞嘉娜
宁宁、老肖、小综	李肖宁
侯铜江	侯桐江
张旭	张馨心
邵小毛	邵夷贝
迪恩·乔加里斯	迪恩·乔格瑞斯
吴信义	吴刚
康飞	康恩赫
阿Ken	林暐恒
张倩茹	张倩如
虎虎	刘锐
庄嘉文	庄思敏
王虎成	王虎城
叶项明	叶相明
丹丹（昵称）	朱赤丹
强尼·威斯坦	乔尼·维斯顿
本·莱温	本·列文
李续良	李绪良
申东艺	申东益
佴雯	佴文
美俊	杨俊
罗心悦	罗梓瑄
暖暖	张煜雯
天秤座	糖妹
宁里	宁理
宝音尼木呼	宝音尼木胡
小乌兰	乌兰其其格
宋文婷	宋汶霏
侯敬宇	侯煜
达伦·莱姆基	达伦·莱姆克
孙小平	孙鹏滨
玛丽·艾格洛普路斯	玛莉·艾格洛蒲露丝
金妮·加德纳	维吉尼亚·加德纳
维吉尼亚·伊丽莎白·加德纳	维吉尼亚·加德纳
夏侯琪誉	夏侯云姗
洪源	洪京京
裕蓥	赵玉莹
九纹龙李逵	李洋
保罗·沃尼克	保罗·韦尼克
李兆霖	李兆林
果果	李芳淙
张竹	竹卿
游熠	游艺湉
悠悠	游艺湉
蓓蓓	游艺湉
湉湉	游艺湉
有一天	游艺湉
熠熠	游艺湉
布莱德·汉特	布拉德·哈德
何宇	何施雨
陈宇凡	陈亦飞
应采霖	应采灵
应志敏	应采灵
王羽瀚	王十一
郭书博	五百
张京宁	张京宇
王丹（原名）	王翊丹
磊哥（昵称）Leon（网配马甲）	夏磊
金杨桦	金扬桦
金揚樺	金扬桦
张鹏义	张鹏翼
徐宝琪	徐宝琦
许宝琦	徐宝琦
李峰	李丞峰
李锋	李丞峰
乐山	杨梓铎
杨铮	杨梓铎
马柯	马浴柯
董子午	董子武
胡琼芳	胡天鸽
达达	宁文彤
钟晓丹	钟小丹
王家禧（原名）	王泽
根中千惠子	梨花
李东艾	李若斯
韩荣昊	韩大昊
谢正辉	谢政辉
北野6	雎安奇
郑嫣琦	郑心潼
马克·亚当·卡普兰	马克·卡普林
安第·纳桑森	安迪·南桑森
王柯楠	王柯
赵真奎	赵真奎
丁建军	丁建钧
黄鹏	黄俊鹏
卡伦·特纳	卡勒姆·特纳
卡鲁姆·特纳	卡勒姆·特纳
周梓言	周子茵
张亚茜	张亚希
杰妮	林杰妮
张祖泽	张圆
张园	张圆
黄懿凤	黄嫀砚
毛妮	毛妮卓玛
小静仔	蔡文静
李盛烨	李晟烨
陆鹏	陆彭
陆棚	陆彭
陆朋	陆彭
黄禾	苗苗
谭义飞	谭安业
袁霆	袁文霆
霆霆	袁文霆
王晓珅	王泷正
拉菲（昵称）	拉菲·卡西迪
李薇薇	方子颖
娜塔莉·埃马努埃	娜塔莉·伊曼纽尔
小岛	王建军
何泓姗	何泓姗
何鸿珊	何泓姗
雅玫	张雅玫
刘希望	奚望
卢小狼	卢一鸣
杨钧丞	杨钧承
洪夕	洪汐
小辰	刘北辰
祯熙凰儿	严丽祯
菅韧姿	菅纫姿
友哥	姜联
恆仔	赵善恒
康璐洁	康琳浠
丁怡卉	丁巧唯
乔·贝尔德	乔·拜尔德
宋梓乔	宋梓侨
宋海梅	宋梓侨
李潇珊	李宛仪
臧启武	臧溪川
魏东生	魏人
苗战武	苗述
郑进华	文江
贾裕玲	贾玲
孙佳一	孙嘉一
安德鲁·森森尼格	安德鲁·山斯尼格
大卫·斯卡帕	大卫·斯卡尔帕
阿兰·达瓦卓玛	阿兰
张润稼	张洋
张扬	张洋
李斯庭	李美慧
牛牛	杨司晨
西单女孩	任月丽
爱德华·斯克林	艾德·斯克林
艾德·斯柯兰	艾德·斯克林
王筱慧	王韵壹
王莉	尼玛颂宋
雷思颖	雷茜
栗建灏	栗昊男
王凡星	凡星
克洛伊·贝内特	汪可盈
张乔夫（本名）	张铮
赵鹏	赵英龙
肖忆郡	肖轶
保罗·考林斯	保罗·柯林斯
马运霆	马浩博
马云霆	马浩博
修满（昵称）小万（昵称）	苏妙玲
蝦頭	杨诗敏
李真	李心艾
维妮	韦娜
伊迪。佳奈悶	伊迪·佳奈悶
蕾妮·维克多	芮妮·维克托
荷西·佩德罗·巴尔马塞达·帕斯卡	佩德罗·帕斯卡
亲王	佩德罗·帕斯卡
乐乐	胡先煦
袁英铭	袁英明
侯颖衍	侯颖桁
樱子	赵樱子
赵韩樱子	赵樱子
予大曦	张予曦
曦曦	张予曦
宋玉玺	宋珉宇
宋铭宇	宋珉宇
郭美玲	郭美美
冯海艺	冯四
斌斌	胡彦斌
小白	刘婧
路知知	路知行
棠棠（昵称）	许雅涵
霍宝珠	霍汶希
刘秉璋	康泰
菲利普·伯卡特	思远
桃子	海伦清桃
阮菁桃	海伦清桃
马兴春	马新春
欧娜·格劳尔	奥娜·格奥尔
单笛文青	张玟芊
单麒汶青	张玟芊
张文芊	张玟芊
苏笠汶	程予希
乐乐	程予希
杨溢	杨镒
兽兽	翟凌
源远	李秋韵
刘芳	刘姝辰
加加博士	蔡景森
钜影张永兴	张永兴
金瀛	张永兴
麒麟博士	王冰
阿曼	阿曼·达博
伊戈尔·达博	东方熠
邹宗胜	邹廷威
郭昱含	郭芮溪
于景霖	于彦夫
小猪	朱珠
高浩源	高浩元
晓凡	郄路通
安静（曾用名）	安悦溪
马克·刘	刘智满
查理·刘	刘智堂
兰斯·刘	刘智福
万里云	张岫云
小汗	韩景龙
杨步停	杨步亭
老克	董哲
胡须哥	李代沫
罗祺	罗棋
罗其	罗棋
罗剑泉	罗棋
小龙	王小龙
谷子	谷尚蔚
本扎	吕克·本扎
司徒以安	司徒颖霜
盛翔	盛一伦
胡朝戈	胡中虎
胡溧桐	胡中虎
张竟达	张竞达
琦琦	王琦
王正军	王政钧
王政军	王政钧
徐记宏	徐纪宏
小张铎	张铎
贺强	贺镪
丁卓	丁汇宇
高人半等	高巍
狐狸	苏鑫
狐狸叔	苏鑫
大龙	孟祥龙
闫霖菲	闫霖飞
金英书	金应洙
金应秀	金应洙
徐建	徐雷智
徐键	徐雷智
刘鹏	刘夏同
蔡宜芬	蔡怡芬
陈咏霞	陈永霞
妮妮	朱佳妮
余积濂	余积廉
余刚	余积廉
龍山本	余积廉
小背心	许靖韵
崔民锡	崔民硕
宋嵩	宋楚炎
阳镇圣	杨真诚
陈霞	阮金红
艾莉·陈	阮金红
石铭华	石明华
屠超	屠夏岩
香奈儿·辛普森	香奈儿
阿梦	岑宝儿
徐志鴻	徐志雄
克里斯多福·范·瓦恩伯格	克里斯·云顿
克里斯·范·达默	克里斯·云顿
刘兆麟	刘知侠
张钊赫	张皓然
李丛喜	喜子
馬威	马志威
馬仔	马志威
杰西卡 范	范立美
壹周	周亚平
胡永红	疏疏
福地祐介	福地佑介
曱甴	阮民安
阮仔、丸仔	阮健恒
斯特灵·杰琳思	斯特林·杰里斯
楚童	陈楚童
陈春生	陈楚童
陈春声	陈楚童
何国锋	小河
严恒瑜（本名）	狄梵
唐山	唐伟成
卓婷瑶	卓予童
卓庭瑶	卓予童
小卓	卓予童
田师傅	田羽生
斯科特·沃夫	斯科特·沃
翟增光	翟小光
海瑟·多克森	希瑟·多克森
王以纶	王旭东
苏那玛·乌达木	乌达木
木木	乌达木
小九	乌达木
尽天涯	罗誉
邝健廉（本名）	红线女
方城	方辉
萨姆·赫泽丹	山姆·哈兹尔丁
吕鑨谥	吕安弦
濮思荀	苏民
陈方骞	陈方千
雅各·特倫布雷（台）	雅各布·特伦布莱
雅各·特伦布雷（台）	雅各布·特伦布莱
李嘉馨	李佳芯
罗宏明	白客
谭峻鹏	尹正
毛毛	尹正
顾绍文	谷白
张弛	张驰
辛巴（呢称）	薛咏煜
小奇（呢称）	薛咏煜
王美好	王琳娜
亚历山大·贝利	霸易
小奇	刘永奇
洛伦佐·卡伦德	罗兰佐·卡伦德
韩也	韩雨烨
金宝凛	韩宝凛
张建陵	张复建
张复健	张复建
張復建	张复建
菲伊·马赛	费伊·马赛
米娅·戈特	米娅·高斯
杜良	杜粮
丹尼·休斯顿	丹尼·赫斯顿
李文	李起弘
张伟	大张伟
刘鑫	刘智扬
王皓一	王浩一
姚洋	高泰宇
陈韦蓉（本名）	韩雨洁
客服妞	管乐
于洪州	于鸿洲
陈捷	陈小妹
董文军	大庆
水咲萝拉	泷泽萝拉
途南	屠楠
罗兰·格雷森·默勒	罗兰·默勒
延桀	言杰
王洪梅	王红梅
王红	王红梅
于艺璇	于莉红
于莉泓	于莉红
王爽	山新
山新德南	山新
山攻攻	山新
女王大人	山新
宋明	宝木中阳
王祯	皇贞季
郑钰滢	陈滢
库表哥	库梅尔·南贾尼
苦荬	库梅尔·南贾尼
無仧	顾虓
雷怿帆	雷金克
马斯舍祚韦	马斯瑟
玛蒂尔达·安娜·英格丽德·鲁茨	玛蒂尔达·鲁茨
野猪桃桃宝	柯哲娴
史黛西·马汀	斯塔西·马汀
谢金壮	谢承均
汪芳	方方
王文琦	王文绮
张可欣	张珊萌
张萌	张珊萌
露皮塔·尼昂奥	露皮塔·尼永奥
罗弋	罗云熙
赵菁	王子清
王梓清	王子清
地狱蝴蝶丸	王子清
杨紫江	杨紫茳
苏善生	李正虎
安索·艾尔高特	安塞尔·艾尔高特
伍冠峯	伍麟凯
吕速鹏	阿速
张勇	小么哥
大镜子	陈婧
水上漂	陈婧
大唐春晓、春晓晓	李春晓
胡真	胡苏涵
李金艳	李金燕
邱璐璠	邱意浓
刘毅	刘云天
宋柳	宋允皓
李景秀	李佳蔚
黄书骐	王书麒
王书祺	王书麒
蔡翰亿	蔡瀚亿
阿富	钱入富
徐静雯	徐靖雯
陈菲	陈一榕
张振锁	张亮
劉憲華	刘宪华
李晓楠	洛诗
虫子（昵称）	丛洋
吴冈桦	苗可丽
王刚	王岗
刘钰婷	曹馨予
胡明钢	胡明钢
崔磊	崔磊
梁晓茵	梁雨恩
静凡	王子
德里差达·贝差拉德	宝儿
紫菜	蔡紫芬
吴姗姗	吴珊珊
创	尹鸿承
尹鸿承	尹鸿承
吴耀冬	夏春秋
森碟	田雨橙
田欣仪	田雨橙
胡靖筠	胡晴云
蓝天	谭惠贞
阿娃·杜威内	艾娃·德约列
范浩然	尚可
克里斯·彭	吴育刚
向琬	向恬冉
刘源	刘昊然
桑蒂诺·丰塔纳	圣蒂诺·方塔纳
徐睦原	徐超
秦飞仔	秦铭禧
卫晓彤	卫晓茼
石头	郭子睿
萱萱	戴潆萱
大山	刘大山
刘姗姗	刘大山
李素萍	金池
亚历克斯·罗斯·佩里	亚历克斯·罗斯·派瑞
里特什·巴特拉	赖舒·彼查
钟永慧	钟采羲
郡主、傻窝、熊孩子、赵英俊（昵称）	赵嘉敏
方晓丽	方晓莉
苏延石	苏廷石
任千妤	连静雯
赵洋	赵曦夕
关怀	关栋天
尕桑见措	格桑
契子	洛森
恬恬（昵称）	王诗龄
天天	张悦轩
龙鲲	李鲲
王隽逸	吉克隽逸
竹子	姚星竹
蒋中炜	蒋中伟
青阳	朱青阳
盖娅·薇斯	盖亚·维斯
盖娅·威斯	盖亚·维斯
克拉拉	李成敏
黑米	小小志
林嘉荣	小小志
任佑明	任言恺
德仔	林德信
江老蔫儿	江雨晨
万琴	万秦
播音名东山博	陈光
刘思齐	刘思奇
邹雪	邹佡
马妍婷	马歌
空巨	董芷依
张晓月	张晓玥
李嘉恒	吴亦凡
安在贤	安宰贤
开开	徐开骋
李俊嵩（原名）	李修蒙
倓宝	崔倓
宝宝	崔倓
赵中训	赵重勋
曹重勋	赵重勋
十字固女王	龙达·鲁西
妍子沁	王妍
图图、汤圆	汤敏
苏曼	速曼
金恩庭	金恩静
唐钰铭	唐睿泽
陈曦	陈祉希
杨光华	杨涵斌
韩陌陌	洪倩
张少淳	阿宝
樊一平	凡一平
森布尔	韩磊
张菊霞	韦唯
乖乖	李璐茜
翁志刚（原名）	翁双杰
齐世龙	齐士龙
周岚	周诗璇
王澜菲	王澜霏
赵雷奇	赵雷棋
朱丽玲	裴殷
杰克·罗斯	杰克·罗思
黄垒鑫	黄海
江超	江奇霖
黄小霞	黄绮珊
小霞	黄绮珊
xixi小姐、小战士	汪小茜
深情的高伟光	高伟光
金五轮	金恩圣
杨彩旗	小彩旗
魏彩绮	小彩旗
小尼	尼格买提·热合曼
宇哥	白宇
白叔	白宇
北老师	白宇
王丽萍	平安
铭浩	马文强
江广玉	姜滇
团团	郑惠馨
昊宇	李昊宇
祖安·史摩	琼·斯莫斯
劳尔·卡斯蒂略	劳尔·卡斯提洛
白芷·雅达乌尤安娜	高慧君
小撒	撒贝宁
小Q	尹淇
皮克·亚历山大	皮可·亚历山大
潘春辉	潘春春
葛元诚	高凌风
周赟	周文武贝
周文	周文武贝
阿米拉·达斯图尔	艾米拉·达斯特
吴华周	吴斌然
东爷 阿吉	吕东霖
叶思齐	李乐儿
晁雪薇	晁然
李帅	李志帅
徐晋璇	墨霏
大辜辜、伯爵	辜承
蔡小茵	龙小菌
林秀芳	林琳
奶茶妹	章泽天
奶茶妹妹	章泽天
吉姆·哈米特	尼克·皮佐拉托
成始洽	成时翕
小绵羊	张艺兴
小狐狸	张艺兴
张加帅	张艺兴
盛惠	盛朗熙
盛朗溪	盛朗熙
钟昀呈	小钟
张倩	张芯宁
倩倩	张芯宁
孙姗（孙珊）	孙歆琦
超级丹	林丹
峰峰九零	王赵国
妮妮	袁锴萌
老湿	朱子奇
金面佛	朱子奇
牙尔机	阿岗·雅尔基
吕妍昕	吕平滢
埃莱娜·吉罗	海琳·吉罗
文晓依	醋醋
张慧雯	张慧雯
励启杰	万力
张长征	征长张
言老施	阎连科
张彦亭	费玉清
费玉污	费玉清
冠华（昵称）	唐冠华
李俊杰	春夏
李祐寧	李佑宁
李祐宁	李佑宁
罗宾·罗德·泰勒	罗宾·泰勒
索珍索朗卓嘎	索朗卓嘎
杨琼	杨壹童
小花	杨壹童
刘晓伟	刘小伟
小凯	王俊凯
陈朝政	朝政
冯准	傲立
偷米	托马斯·米德蒂奇
罗小伊	南笙
石铭晖	石明辉
郭冬冬	郭纬
孔女神	孔连顺
婧伊、伊伊（昵称）	赵婧伊
李炘蒙	李元鹏
晏斌泉（笔名）	安寨彬
吴宗修	吴军
莱维·赞恩·米勒	莱维·米勒
黑人黄晓明	约翰·博耶加
黑人景甜	约翰·博耶加
小爱	刘浩
王平超	麦子
宇文	刘志宏
李洛伊	李洛伊
维恩·派瑞	韦恩·佩雷
清水尋也	清水寻也
千总	易烊千玺
烊烊	易烊千玺
小千千	易烊千玺
大佬	易烊千玺
汪鎬朗	汪鸿坤
陈杏妍	雨书
陈开心	雨书
羽田昌义	羽田正义
卢丽莲	卢觅雪
随风	曹随风
大刚	姜志刚
蒋志刚	姜志刚
阿比盖尔·克莱因	阿比盖尔·克莱恩
曹大璐	曹璐
欧阳万成	欧阳万成
吉米·欧阳	欧阳万成
梅利莎·马尔斯	梅丽莎·玛斯
陈清珠	陈立中
李永昌	李勇昌
陈辰	陈晨
凯迪	杨凯迪
易南（笔名）	焦文军
小美	赵秦
徐正云	徐正运
黄浩骅	黄浩华
紫曦	陈籽熹
多多	黄忆慈
多妹	黄忆慈
可爱多	黄忆慈
黄搞笑	黄忆慈
趣多多	黄忆慈
董熹善	董熹璇
董熙善	董熹璇
东喜善	董熹璇
玛丽亚·卡尼亚	玛丽亚·凯拉
李家成	李砚
小白	白举纲
贾子胥	贾盛强
居来提·库提来	居来提
塔伦·埃哲顿	塔伦·埃格顿
蛋蛋	塔伦·埃格顿
欣欣	王欣雨
扣扣周	科林·乔斯特
虎妞	唐伯虎
卢卡斯·海吉斯	卢卡斯·赫奇斯
黄志坤	艾明之
栾天	栾元晖
肖恩·迈克尔·维里	肖恩·维里
陈志鹏	汤尼陈
匡自文	宽叽文
涂珊	阿诺
蔡阿嘎	蔡纬嘉
唐静（本名）	唐小喜
曾雨	今何在
杨俊宇	杨竣羽
杨文昌	杨阳洋
羊羊羊	杨阳洋
杨杨杨	杨阳洋
立方羊	杨阳洋
崔达志	崔达治
费曼	费曼
吴费曼	费曼
小曼	费曼
阴灿姝	任梦
新月冰冰	张韦
郝翔海	郝祥海
On仔	陈健安
皇上	吴崇铭
张牧野	天下霸唱
舅	曹三丰
肥嘟	曹三丰
啾儿	曹三丰
棉花糖哥哥	曹三丰
程十庆	十庆
贝儿	陆雨萱
李彩林	李彩麟
李彩琳	李彩麟
任英健	阿健
李鈞天	蓝钧天
蓝均天	蓝钧天
吳珮綺	吴可熙
安纳斯塔斯莉娅·沙迪科娃	安娜塔莉亚·沙迪科娃
应俊	应昊茗
阎伟	爱迪生
玛格丽特·奎利	玛格丽特·库里
杨天祥	杨天翔
闫清秀	阎清秀
付少杰	傅绍杰
老内	白雷森
方数真	方妍心
方星穎	方妍心
廉梦	葛布
保洁小妹	葛布
小美	葛布
姐姐	曹华恩
姐姐公主	曹华恩
包子妹	曹华恩
蜡笔小新	曹华恩
大姐姐	曹华恩
黎萱	黎一萱
乔斯林·德波尔	乔斯琳·德波尔
碧翠丝·玛丽娜·路易丝·韦斯曼	玛丽娜·维丝曼
赵骏	上白
高志宏	高允汉
张旆华	张沛华
严志诚	严志成
瑞安·佩维	瑞安·佩威
瑞安·雅各布·佩威	瑞安·佩威
瑞恩·佩威	瑞安·佩威
李娜	李佑晨
朱颜曼姿	朱颜曼滋
杨文豪	杨振豪
金鑫	金泽灏
金泽翰	金泽灏
莫春林	莫西子诗
洪奇翰	禾浩辰
布鲁斯	禾浩辰
姜胜允	姜昇润
姜承润	姜昇润
姜承允	姜昇润
臻荣	张如荣
海涛妈	柳英霞
彭波	彭博
小白	白敬亭
白rap	白敬亭
艾斯特·加莱尔	艾斯特·加瑞尔
伊斯特·加瑞尔	艾斯特·加瑞尔
南航校花	陈都灵
史浩辰	孙浩辰
孙昊辰	孙浩辰
贾景辉	贾景晖
唐马儒	李迪
徐朱玄	徐珠贤
徐玄	徐珠贤
徐贤	徐珠贤
卓格赫	卓·格赫
爱新觉罗.永新	史彭元
大成	郑业成
小马可	马可
程砚萩	程砚秋
小D	丹尼斯·凯恩
凯恩	丹尼斯·凯恩
小凯恩	丹尼斯·凯恩
暖男Kane	丹尼斯·凯恩
豆子	李梦颖
金振宇	金秦禹
马诗婷	夏宇童
小米	夏宇童
吉娃斯	夏宇童
小菲、菲菲	龚玥菲
石峰	石峯
郭球成	郭秋成
约翰·波格	约翰·波罗
唐七公子	唐七
朱东旭	朱子墨
毛毛虫	霍小雷
红果果	陈苏
绿泡泡	耿晨晨
欧轩伟	区轩玮
阿黄	黄正杰
詹姆斯·格雷西	詹姆斯·亚历山大
冯盛	图特哈蒙
寇姬·齐尔斯多夫	科齐·齐尔斯多夫
王晓迪	九夜茴
李渊	李炳渊
小绿	李炜
胡及恩	源子夫
甜馨	贾云馨
华艺涵（原名）	华娇
佟志坚	佟亦坚
嘎嘎 +2  852	王嘉尔
霸道总裁	王尼玛
大头怪婴	王尼玛
隔壁老王	王尼玛
老卢	卢恒宇
小古天乐	张传奇
满囤儿	卢少科
十三妹	蒋羽熙
代贝贝	代超
史蒂文·斯韦德林	史蒂文·斯沃德林
金泰錧	辉灿
金泰冠	辉灿
琳琳	壹达恩
从艺	丛兿
袁伟	袁福福
皮耶馮索馬汀拉佛	彼埃尔·弗兰斯科·马丁·拉弗尔
德里克·克尔斯塔德	德里克·科尔斯塔
许正庭	许正廷
周晓滨	周小镔
张晓燕	张欣颜
曹金铃	曹金玲
金楷杰	金草
税洁	税瀞熙
牛爷（昵称）	俞才斌
杜胤伟	杜子名
郭许炜	小小白
白胖子	小小白
白少	小小白
白殿	小小白
大白	小小白
白白	小小白
雷陈媛	彤阳
王静	王静儿
郑宁	宁子
刘富强	刘强富
鲁比 罗丝	鲁比·罗丝
尉迟少男	尉迟少南
李燃	小夕
戚茜	戚珍琪
孙皎龙	孙蛟龙
毛毛头	张雪凌
雪凌	张雪凌
喵小蓉	朱蓉蓉
徐静	小连杀
萝安·查巴诺尔	洛安·沙巴诺尔
王倩	王晗羽
李文钢	罗西
陈淳	陈真希
蒙蒙	黎筱濛
蒙莓	黎筱濛
四刀辉彰	黎筱濛
黎小萌	黎筱濛
黎筱蒙	黎筱濛
天屎JILL李姝洁	李姝洁
申秋香	朱雀橙
昂哈尼玛	昂哈妮玛
克里斯蒂安·巴齐尼	阿抗
张海鹏	冯唐
王玲玉	王初伊
恬恬	刘楚恬
小恬恬	刘楚恬
伯鲁（字）	马师曾
景参（号）	马师曾
慈善羚羊	邓兆尊
尊哥	邓兆尊
曹镇模	曹溱模
刘一	刘俊孝
马汀·桑斯迈耶	马丁·桑斯梅耶
林珍儿	林珍娜
骏雄	廖骏雄
蒋文瑞	蒋文端
扎卡	韩飞行
费霞	林允
飞侠	林允
胡小光	胡晓光
罗浩轩	罗光敏
不二	高旭东
黃麗玲	黄丽玲
大王，格格，礼格	黄礼格
刘俊龙	西蒙子
西萌子	西蒙子
西门子	西蒙子
崽崽	西蒙子
王沛绿	王沛禄
江陽	江扬
杨江	江扬
张帆	张熙媛
惠杨子	谢逢松
谢蓬松	谢逢松
猫先生	崔光辉
鲁昕	鲁昕儿
王垚	王汉词
啊斌	郑无边
甜筒辉	郑文辉
小煜	杨奇煜
阿纬	刘俊纬
威廉	廖亦崟
廖威廉	廖亦崟
豆豆	司徒芃丽
跳跳	张哲浩
磊磊	张哲浩
最后的卫道者	高岩
纷舞妖姬	董群
风舞妖姬	董群
阿霄	陈咏霄
王振	王真儿
歐瑞偉	欧瑞伟
怡宝	孙怡
陈莹	右耳
加隈亜衣	加隈亚衣
麻吉弟弟	周立铭
韩霄宇	韩承羽
菲利普·乔利	狼森
谢正浩	谢炘昊
浩子	谢炘昊
浩角	谢炘昊
浩角翔起	谢炘昊
吴素珠（本名）	素珠
哈法·朱利叶斯·博瑞森	哈弗波·朱利尔斯·比昂森
哈夫珀·朱利叶斯·比永森	哈弗波·朱利尔斯·比昂森
小奥西亚·杰克逊	小奥谢拉·杰克逊
小欧席亚·杰克森	小奥谢拉·杰克逊
康斯坦斯·吴	吴恬敏
涵冷娜	许乃涵
彩虹姐姐	赵舒婷
董龙	梁董龙
程晓燕	禹童
小邓丽君	桐瑶
张韡	张大大
谢尔盖·鲍鲁宁	谢尔盖·波卢宁
瑟盖·普罗宁	谢尔盖·波卢宁
海洋（艺名）	马率
灿灿	黄灿灿
灿宝	黄灿灿
火山	黄灿灿
祖·艾云	乔·阿尔文
乔·艾文	乔·阿尔文
乔·欧文	乔·阿尔文
项宏敏	项华祥
项宏明	项华祥
王予柔	王棠云
傅信盈	傅舜盈
中童西	钟童茜
妹妹	甘雨
葉天行	叶天行
中国乳神（昵称）	樊玲
萧昭发	萧大陆
郑淼之	郑媛元
奶茶	刘敬雯
李捷	李婕
翟凯泰	泰臣
夏天	王紫璇
任太雄	林大雄
周聪华	周婷
战晓丹（曾用名）	战鹤文
王一正	伊正
唐也可	唐伟
金介文	喜翔
君主（昵称）	韩东君
阿喜	林育品
阿喜妹	林育品
王玮楹	王玮
张倞耘	小甜甜
张芳奕	小甜甜
张可昀	小甜甜
阎志扬	阎肃
亮亮（呢称）	郭亮
天台杀手	许少飞
陶德三	郭筝
应天鱼	郭筝
张何	张何俊伟
杨岗丽	杨钰莹
岗岗	杨钰莹
美岗	杨钰莹
岗宝	杨钰莹
道长	梁文道
王若涵	王嘉禾
罗漩	罗璇
吴岩妍	吴妍妍
何致强	何志强
何俊昇	何志强
何致谋	何志强
何俊升	何志强
马薪蕊	马茜蕊
藤井树	吴子云
嗨呀吴	吴子云
孙萌主（外号）	孙晔
彭鸿禹	彭禺厶
秋子	刘秋实
金雨霏	金洛伊
拉娜·康多	陈东兰
陈彤兰	陈东兰
郑文华	郑文华
黄梦颖	黄梦莹
吴暇	吴瑕
王锋	都日昭日格图
郭云奇	郭云齐
郭帅祯	郭云齐
子小号	孙浩
慕一华	慕钰华
湾湾（昵称）	邱欣怡
南泰铉	南太铉
南泰贤	南太铉
丽娜	邢美美
肖柏瀚	肖飞
李炫臻	李思函
雪糕妹妹	李思函
艾连诺•沃辛顿-考克斯	埃莉诺•沃辛顿-考克斯
张琪	张玉华
小鞠	鞠婧祎
kiku酱	鞠婧祎
鞠神	鞠婧祎
盟盟	谢海盟
旭日阳刚	刘刚
五折，人人（昵称）	吴哲晗
桂华政	阿桂
发卡	李艺彤
白发卡	李艺彤
徐磊	南派三叔
钱钱，钱少，钱妹（昵称）	钱蓓婷
葛兴龙	华容
高鹏程	华容
闫维文	阎维文
陈家兴	陈加兴
李屁	李频
黎妍	黎一墨
达达	花粥
游游	郑雅文
大师兄	杜俊
寇俊	寇骏
耿立树	耿力树
天天	徐小琴
方雁	方从伊
朱达·刘易斯	犹大·刘易斯
路易斯	犹大·刘易斯
蒋春玲	辛夷坞
黄思维	黄翀
黄思繀	黄翀
付梅	付枚
前田真剑佑	新田真剑佑
真剑佑	新田真剑佑
麻博阿维墨布文湘	墨布文湘
陈晓柯	柴格
姜小帅	陈秋实
万晓丽	童鑫
阿飞	薛晨飞
大宇	冯建宇
徐远	徐子沅
王艺佳	王艺嘉
梦婷	赵姝婷
小倪萍	张纯烨
卞智弘	卞智洪
方柏霓	方芳
蕾切尔·丽桑·布鲁姆（全名）	蕾切尔·布鲁姆
艾莉森·苏朵儿	艾莉森·萨多尔
裴成宇	裴晟祐
裴承宇	裴晟祐
裴晟佑	裴晟祐
妞妞	李倩妮
大柱子	金圣柱
陆韵煊	陆妍淇
陆小花	陆妍淇
露露	陆妍淇
晏积瑄	晓晏
晏积王宣	晓晏
高峰	高枫
乔西·托塔	J·J·托塔
宗潭	孙钦军
龙叔	龙斌
空巢老人	龙斌
央视旁白哥	龙斌
郭依琳	郭依林
蔡主任	蔡照
蔡老师	蔡照
蔡先生	蔡照
婷婷桑	黄婷婷
白晶晶	白晶
王波	王梓尘
莎莉翁	李志荟
李钰阳	李志荟
拜跃	拜月
阮伟旌	阮圣文
头目	杨涵博
邹正	邹文正
邹正勤	邹文正
苏民立	苏民峰
施权展	施展
奥娜·劳伦斯	乌娜·劳伦斯
李婉儿	婉儿
凌智豪	白只
强子	周强
大卫·莱斯利·约翰逊	大卫·莱斯利·约翰逊-麦戈德里克
大卫·约翰逊	大卫·莱斯利·约翰逊-麦戈德里克
琪琪	成琪
古丽米娜	古丽米娜·麦麦提
赵煜鑫	赵毅新
程俊博	程韦然
叶思彤	叶思浵
米高	迈克尔·帕克
靳雯涵	靳梦楠
梦楠	靳梦楠
赵佳蓉	落落
解小东	解晓东
达人	达伦·格罗夫纳
杨冰	杨树林
石文嵩	文松
李耀敬	李耀景
姜人衍	姜怡伊
唐夙凌	林簌
范恬恬	范湉湉
宙斯	索墨
曲老师	曲家瑞
安金莉娅	安金
涛涛	符涛
七条	黄柏基
赵雅顿	赵雅顿
雅顿姜	赵雅顿
蔡雅顿	赵雅顿
令狐庸	冷杉
阮氏娴	庆媚
庆美	庆媚
柳桂栋	柳珂
奕彤	阴奕彤
扎克·爱尔兰·施普利特格贝尔	左右
二龙湖浩哥（昵称）	张浩
冬冬	袁冬冬
殷宝莹	殷樱
安纳斯塔斯莉娅· 沙迪科娃	草莓
齐白	闫世盛
逯恣祯	逯子
刘容	刘蓉
查尔斯·帕克利	张锦惠
克里斯多夫	马建军
李亚珍	李亚真
彤彤	李亚真
二哥、魏少、二宁、宁宁	魏一宁
季燕飞	季航锋
齐飞	亓飞
琪琪	成梓宁
凤凰传奇	曾毅
凤凰传奇	杨魏玲花
张淑婷	张洋
小飞	吴剑飞
藤新jiven	藤新
刘冠麟	刘冠霖
郭雷	郭大雷
谢承勋，丞勋，彬彬，帅彬彬，长腿彬	谢彬彬
苏小桐	苏晓彤
王涛（原名）	王铮
石头	石昊正
耿卫国	檀冰
梅昕	梅新
大亨	周嘉亨
四儿，小四（昵称）	林思意
树树	卓雅雯
陈皮诺	皮诺曹
梁登凱	梁登凯
小北	孙珂
赵燕	赵国燕王
双儿 伊伊	胡洁琼
喜连娜	喜莲娜
云中	李云波
铁哥	周铁
赵琦	赵麒
李川	李川
大川川	李川
川哥	李川
李飞	李国鸿
玩世小妖	陆培
桐溪	高歆迪
卓小然	幺依田
澍苗	白澍
杨春辉	杨春晖
何可人	何静
张娇	张天爱
小爱	张天爱
老公	张天爱
马嘉琳	海铃
哈默	张艺瀚
陈建	陈剑
李浩章	李思臻
东东	吴婕
安安、安小安	石悦安鑫
局座	张召忠
美浓轮	美浓轮泰史
聪哥	汪聪
王荣荣	王荣荣
白牡丹	王一博
小王子	王一博
李军仁	至尊玉
至尊帅	至尊玉
玉导	至尊玉
钟骏儿（本名）	钟一宪
鍾一憲	钟一宪
李雪	李一桐
爱纱	千田爱纱
王子桀	王子杰
雷深如	雷琛瑜
消音姐（昵称）	孔肖吟
那那西	冯薪朵
朵朵	冯薪朵
小怪兽	刘炅然
兽儿	刘炅然
桃子	李钊
鲸鱼	黄景瑜
蔡紫缇	弯弯
张彤	张丹三
嘟嘟	陈怡馨
笨笨	谢天依
洲洲	许魏洲
张慧	张宛庭
晴格格，闷闷	郝婉晴
鱼哥，鱼酱	刘佩鑫
绵羊，步美（昵称）	许杨玉琢
十七，鸡宝	龚诗淇
守年，爱酱	易嘉爱
撸力、阿芬、芬达、曾小野、琉璃	曾艳芬
叉叉（昵称）	张雨鑫
叉总（昵称）	张雨鑫
叉弟（昵称）	张雨鑫
渣渣（昵称）	张雨鑫
猪仔（昵称）	张雨鑫
小雨（昵称）	张雨鑫
娜娜、Nana、娜宝、娜娜酱	万丽娜
小姐姐	唐安琪
橙子	陈问言
豆芽	陈问言
晓晓，晓玉	何晓玉
小艾、少主	陈观慧
芸姐	蒋芸
未来	蒋芸
毛毛、鲤鱼 （昵称）	李宇琪
三妹、芮哥（昵称）	孙芮
小双	沈之琳
温温	温晶婕
圆圆，源帝	费沁源
CC酱、大C、歌姬C （昵称）	徐晨辰
大米	李晶
水水，二水，小恶魔	杨冰怡
菌菇	闫明筠
栗子	张怡
大哥	陆婷
璐宝	王璐
妮子，蟹老板	谢妮
谢心悦	齐浠儿
稳稳	陈稳
王秀彤	秀之树
郭議芯	郭奕芯
郭议芯	郭奕芯
彭彭	彭昱畅
任军	大兵
索妮	常索妮
小鹿姐姐	郏捷
月亮姐姐	王淏
哆来咪	何子然
王晓伟	王小玮
刘睿恒	大狸子
王阳	老狼
李小军	李晓军
韩冰	大兵
宋国峰	宋晓峰
孙金山	孙小飞
胡新超	小超越
凯蒂·萨沃伊	凯蒂·萨瓦
蒋八首	蒋大为
吴博伟	叶良辰
东方月初	李宏毅
格格	王鹤润
黑静环	黑婧环
娟子	张萍娟
松少	刘青松
瓜爷	林乐乐
储晓祥	中泽祥
北美崔哥	崔宝印
曾剑峰	曾剑锋
高光佑	高扬棋
高杨棋	高扬棋
高鑫	高扬棋
杨乐乐	杨济妤
崔程程	崔恬伊
冯辉	冯晖
著姐	刘著
陈道贤	陈大天
小虾	陈大天
刘琼	刘冰
胡建林	碰碰和
七爷 郭仔 郭帅	郭卫鹏
梧桐	吴桐
宁瑞芹	宁怡
王颖	王郢
张鸿铭	张洪铭
大飞	吴志庆
杰克·埃利奥特	杰克·艾略特
华安	李文龙
黑子	吴俊贤
林庆隆	林子皓
李倩	李晨溪
岳喜瑞	岳野
岳中平	岳野
岳庄	岳野
周国斌	周国宾
大眼儿	曾舜晞
毛毛	谷嘉诚
老谷	谷嘉诚
赵晶	赵彦乔
阿祖,君君	孙祖君
何鹏飞	大飞
王文通	王文通
公子有喜	王文通
林帅	深耀
庞洪涛	庞瀚辰
梁滨	梁斌
程程	程紫城
大奎	朱洪振
夏沫侨	李欣烨
玉妲	玉坦
鬼冢	鬼塚
郭奇林	郭麒麟
虎哥	曾伏虎
舒编	舒广袖
浪客秦昊	秦昊
张亮	张小厚
徐福晶	徐鸥仪
姚慧如	姚惠如
崔铭元	崔明浩
刘国亮	刘凌志
付晓娜	傅晓娜
郝啓田	郝启田
褚娇月	褚楚
张圆圆	张德兰
圆圆	张德兰
小林哥	张晓林
袁仁康	袁再显
杜懌超	杜怿超
珩采尘	李晨雨
赤雪	赵晨妍
女神（昵称）	林楠
朱朱	朱元冰
包小铭	包伟铭
钱宥佑	红木
小伍	伍嘉成
小队长	伍嘉成
hana、蕾蕾	谢蕾蕾
威廉弟弟	王元也
王道扬	王耿豪
麥芷誼	麦芷谊
高晋	谢爕隽
潘洁	潘结
曾伟明	曾玮明
许诺	许之糯
吕明光	尹光
张珮莹	张允曦
小8	张允曦
张佩莹	张允曦
徐健宇	徐亨
阿翔	陈文翔
翔起	陈文翔
浩角翔起	陈文翔
胖丫	赵丹
江涵月	江佳桐
核桃	周彬
奶茶超人	葛张君
朴姗	朴珊
陈博	陈博
安妮	安妮
陈恭捷	天海无贝
杨画	夏一可
谢梓彬	谢紫彬
梅云	梅寒
小帅	陈旭
杨太郎	杨霖
金树贵	金书贵
藏秀云	臧秀云
陈骁潇	陈潇骁
如意	杨苏
朴金玉	金尤美
小花猫	周弋楠
吴嘉诺	吴品儒
吴小健	吴品儒
黄瓜	黄扬梓淇
悠无一品	不思凡
杨志刚	不思凡
梁依	梁艺馨
王艳萍	王艳平
孙建宏	孙建宏
阎鑫	阎鹤祥
王梓璇	王梓璇
陈竹升	陈竹昇
施晓菊	施小菊
郑矗立	郑楚一
宁泽	宁小花
菲林橙	崔辰
亦涵	康亦涵
何佳镁	何乙轩
何淼	何乙轩
轩宝	何乙轩
韩渤宏	韩博
葡桃	梁栋
一凡	凡一
约翰·佩斯里	裴中中
苗苗姐姐	李渺然
张轶琪	张轶祺
西呱双	苏尚卿
陈阳	晨阳
张泸方	张亚光
驼峰	张法纯
许云建	许建
许建建	许建
许小建	许建
许大建	许建
风清扬	马云
李新杰	李锦伦
仔哥	王子鸿
烧饼	朱云峰
捷哥	郑熙岳
张成楚	小小岳
朴成男（本名）	朴成镇
王玉青	王玉清
王昱清	王玉清
张博泓	张思帆
小苹果	安淇尔
安迪	斯托克斯·安德鲁·查尔斯
夏克平	夏天
弗拉德	卷弗
何林骏／林骏	森竣
闫妮	阎俊希
步小熙	桑砚
小朵	刘木子
大美玲儿	姜思达
唐鑫辰	唐豆豆
欢欢（昵称）	彭楚粤
白雪	白雪岑
得胜与鲍勃	李得胜
刘军利	刘眀泽
阿利	刘眀泽
秋皓	齐虹
彭国梁	彭皓锋
彭冠中	彭皓锋
彭比得	彭皓锋
任国超	任嘉伦
姜大龙	姜震昊
赵颖	赵梓源
冯玮	冯芷墨
褚会林	禇会林
拉面二娇	韩娇娇
张栩醇	书亚信
宋佳宁	宋宁
财宝、海陪寺	叶琳
C小调-Olivia	佟心竹
C小调	佟心竹
李念堪	李唐
谭婷	谭嬣
谭宁	谭嬣
叶青青	叶新晨
大可爱,段短短	段艺璇
荔枝	李梓
梓宝	李梓
阿梓	李梓
江山	姜杉
珮珮,爸爸,一片云	洪珮雲
张圣	张圣
叮当	张圣
陈世颂	陈楚月
李安貉	李清楚
张净桐	张超
珍妮	孙珍妮
香港小紫藤	罗云琦
执	赵志伟
易恩	易柏辰
吕鋆峰	吕昀峰
陶洧屺	陶多多
宋昊林	宋灏霖
缪克瑾	缪倩
刘显达子	刘显达
冯星琳	冯海煜
林汉洋	汉洋
东东 东哥 小东	晏紫东
金侑美	金瑜美
神喵、瑶瑶	沈梦瑶
饺子、鹿角	王露皎
刘汉朴	刘汉璞
金峰	金风
彭名燕	彭铭燕
豆豆	彭梓桁
诺明花日	诺明骅日
第二次爱你高峰	高峰
于柏洋	于柏杨
小好	郑好
金振秀	金不换
李显钊	李尚山
李思瑶	释小松
包子	胡晓慧
刘佳鑫（本名）	刘育同
天悦	侯天悦
章东升	张东升
花姐	贾玉华
房柏妤	房夕婷
盛超	盛冠森
王瀚邦	王一鸣
催华松	崔华松
吕卓达	吕毅
鍾舒祺	钟舒祺
夏裕介	波多野裕介
安德鲁·葛人杰	安得烈·格兰杰
王欢欢	卜冠今
小樱桃	陶奕希
一品	杨峻
爱姐	刘天蔚
庆庆	蔡轩正
安吉	沙俊伯
阿拉蕾	崔雅涵
阿拉蕾雅涵	崔雅涵
能叔（昵称）	李凯诗
王嘉丽	王彩莉
王佳丽	王彩莉
冰冰（昵称）陶冰蓝（陶冰蓝）	陶冰蓝
银铃娃娃	周芷莹
微群：https:	杨纳娜
胡轶柯	胡轶珂
韩冬	韩东
小才，小黄，黄大，噗爷，仓鼠哥	黄靖翔
微博：http:	周艺
小鬼	陈意岚
鬼妹	陈意岚
小米	宋永恒
彤耀忠	肜耀忠
朱涵燕	朱庭辰
小斯琴高娃	田东霖
桑肆柒（笔名）	桑博文
贝贝	唐贝诗
彭华刚	刚子
敖登高娃	奥登高娃
陈梦秦	梦秦
麦弘文	贾斯汀·麦伦
徐雷	徐蕾
杨保龙	杨宝龙
许腾介	许腾方
朱舫	朱古力
戴雯菲	戴菲
韩烨州	韩烨洲
大壮	韩烨洲
韩塞的马达加斯加	小马达
李明珠	李春嫒
李春媛	李春嫒
韩姨	韩颖华
潘欣欣	穆熙妍
李小飞	李晓飞
高梵	安东尼·加瓦德
冯谦	冯千
周鹏	周澎
老杜	杜煜峰
东北花泽类	杜煜峰
顏毓麟	颜毓麟
汤娜	汤那
王仕颍	王仕颖
李中希	李忠希
郑凯元	郑拓疆
西西	贝逸宁
白毛哥哥	阮凌峰
司斯	阮凌峰
阮灵方	阮凌峰
钛	阮凌峰
阮国名	李俊杰
黑毛哥哥	李俊杰
胡嘉雄	胡家雄
何嘉红	胡家雄
黄毛哥哥	胡家雄
邹优杰	邹德江
德江	邹德江
侯梦琪	候梦琪
范炜	范玮
高大拙	高超
高超	高超
高超	高大拙
峰哥	王永峰
皓月	张昊玥
张皓月	张昊玥
付小仙	付思琪
童可可	童可可
可可	童可可
童话	童可可
童小话	童可可
诺姐	李诺
姜雨辰	姜尘
李勇	本李
童童	窦靖童
释恒尊（法号）	王云昊
陈晨	林千鹿
双儿	溪格
蔡刚	蔡纲
鑫淼	欧阳鑫紫
鑫紫	欧阳鑫紫
鱼丸	青钰雯
公主	陈慧娴
白羊	胡皓翔
焜哥	张智焜
张津肇	大宝哥
张零	张漫文
杨奕	臭屁坨
本名马秋梓	马秋子
阳阳	马泽涵
子寒	郑子寒
郭星星	郭星显
霹雳爷们儿	王梁
大梁	王梁
徐粒嘉	张凯源
叮叮	邵琨
陈侨亮	陈威男
陈乔亮	陈威男
裸奔哥	厉槟源
方丽萍	方苹
薛飞（本名）	华斯比
华少（昵称）	华斯比
华胖（昵称）	华斯比
陈羽芊	陈禹岍
大含（昵称）	刘芷含
老毕	毕安社
李志峰	李拾壹
柏木七海	阿部乃美久
陈徐	紫金陈
钟裕，阿鱼	钟彧
博林	尹博林
石头	施涛
栾剑	栾浚威
付永俊	文东俊
姜逸磊	Papi酱
杨季康	杨绛
小乔	杜小乔
娘娘	杜小乔
杜小喬	杜小乔
口口一	吕一
橘子	刘菊子
丫丫	张雅梦
静静	祁静
小七	徐诗琪
甜甜、丽丽	田姝丽
小熊	熊素君
小纳米	胡博文
陈琳	陈嘉琳
荷花	林溪荷
小牛奶	刘姝贤
芝麻	张梦慧
小巨人	陈倩楠
隋君卓玛	隋源
张倩	张敏倩
徐佳琪	徐佳琦
迪玛希	迪玛希·库达依别列根
付敬恭	傅敬恭
小凡	瞿凡壹
严永宣	严永瑄
小北、元素	冯思佳
冰糖雪梨	罗雪丽
玉子	马玉灵
小星	顼凘炀
牙妹	李娜
多肉	陈雅钰
房总、蕾宝	房蕾
葛格、鲜鲜	葛司琪
黄老板（昵称）	黄恩茹
蛟娇、焦糖	李泓瑶
雪饼	刘闲
柚柚、怡夏子	任心怡
芋圆	王雨煊
社长、二毛、日华	杨晔
喵喵、猫猫、甜心教主	叶苗苗
锦鲤	张怀瑾
CK、珂导	陈珂
小狐狸、二源	高源婧
悠悠、大大	刘筱筱
微博：http:	刘紫璇
朱一文	朱哲健
姜佩瑶	姜珮瑶
小树	刘胜男
刘玉璞	刘美彤
元子	王庆元
水鸡	李树浩
陈旭	陈玺旭
肥波	孙冬冬
周宏	周虹
张嘉仁	小颖子
迪克牛仔	林进璋
张文	张连文
李宝成	李保成
吉列尔莫·达尼诺·里瓦托	吉叶墨
吉叶墨·达尼诺·里瓦托	吉叶墨
薇拉贝儿	薇拉贝儿
米菲	刘力菲
倩倩、圈圈、677	刘倩倩
卢不闹、总裁、小精灵	卢静
丫丫、士力架	唐莉佳
小铃铛	肖文铃
蒸蛋泥、懒蛋蛋	郑丹妮
璃笙	付紫琪
李晴天、兔牙	李慧
肥肥	卢天惠
赖赖、糯米	赖梓惜
小敏	孙敏
懵懵	王诗蒙
蕊妹	赵佳蕊
陈炳林	欧帕瓦·吉沙晚迪
李青瑶	钉铛
叮当	钉铛
李鑫	李京泽
波哥	李波儿
安娜金	韦毓雯
木易	杨一帆
曹小强	巴特尔
刘金霏	金霏
嘻哈包袱铺陈曦	陈曦
冷海鸣	冷海铭
杨河灵	曲亮鹏
许剑	许紫青
许烨	许紫青
郑明心	提迪蓬·德查阿派坤
阿邪、邪酱	陈桂君
蚯蚓、阿喵	杜秋霖
囧囧	王炯义
四月、菜菜	王偲越
韩子靖	韩子婧
陈心蒙	陈心豪
张懿靖	张懿暄
童川（别名）	王彤川
敬山童（号）	王彤川
李玉洁	李沐宸
MC天佑	李天佑
陈沛光	陈沛江
陈佑华	白桦
陈文淇	文淇
顾笑颜	顾笑言
徐平（本名）	须一瓜
张暘	张旸
石秉真	罗曼迪
罗基石	罗曼迪
吐依贡	吐依贡·阿合买德
梅丽古丽	梅丽古丽·艾买提
谢克朗	肖朗
胡尔西德	胡尔西德·吐尔地
尹海杰	海桀
吴声樾	吴荫循
候永生	侯永生
铛铛	李牧芸
李玲	李牧芸
夏可可	黄依夏可
王润泉	杜澎
安柚鑫	安佑森
常佳音	常佳茵
张泰维	泰维
爱菲儿	陈意涵
李加	李加雅德
康康	梁靖康
润导	陈润
闫婧璇	闫露娢
梦妍	孟妍
白金铂	白金泊
张均	张筠
舍言	张筠
蓝小咩	蓝淋
张家硕	张家川
特特	王特
特爷	王特
叶尔江	叶尔江·马合甫什
李朱英	李祖英
李柱英	李祖英
黑鹰	瓦其依合
飞鹰	沙玛拉且
麦麦早	彭子苏
小添	裴子添
豌豆儿	张靓
张慧志	张惠志
小朵儿~	陈朵朵
小菲	张菲菲
向一鸣	向奕铮
长谷川永远	长谷川真理
白丽丽	白翎
尚叔欣	尚长荣
筱玮	叶筱玮
小玮	叶筱玮
马睿马同学	马睿
会长	马睿
果猪	荣超
潔儀姐姐	袁洁仪
朵朵	李正彦琦
田裕民（原名）	石舒清
光光	夏之光
陈泽浠	陈泽希
吕米多	吕行
施洁强	施节强
鄭恕峰	郑恕峰
于世彬	于石斌
向西	向西村上春树
蓝之光	兰之光
微群：https:	姚奥依
郭飞鸽	郭飞歌
虞军	于军
方圆	方妤萌
钟宝儿	钟熠璠
微博：http:	周漾玥
奶糖	金东黎
微群：https:	孙伊雯
郑则漫	郑湫泓
郑泽漫	郑湫泓
小漫	郑湫泓
杜子春	张萌
微博：http:	罗熙怡
马雄	凯文·马汀
马汀	凯文·马汀
汤神	克莱·汤普森
谷美腻	谷艺璇
婉儿	张婉儿
孟丽魁	媚媚猫
孟孟	媚媚猫
王跃晋	王跃进
王耀晋	王跃进
车父	祝君
李健	李悦溪
常佳	游非
秋月	邱悦
张果	张巳阳
王丹	王九苓
李沁霏	李咏儿
崔洢静	崔一静
七斋	高国斌
军哥、军军	全建军
陆羽	路羽
卓淇仔	王卓淇
戴佳夕	代佳夕
丁当	张咏娴
笛笛（昵称）	戚砚笛
马晓军	马圣彬
赵建雷	赵健雷
范佳其	范家其
启杰	陈启杰
乔克己	乔克吉
曹连芳	曹美丽
洪紫琳	洪冰瑶
肥腸	徐浩昌
伍只柠檬	伍宇辰柠
沈玟雅	米娜
甜甜	韩蕙羽
库尔特·乐	库尔特·岳
一姐（昵称）	虞祎杰
钟羽	韩忠羽
锺羽	韩忠羽
龚朝晖	龚朝
龚朝辉	龚朝
陈松桦	陈震
辣条（昵称）	谭博文
带路	代艺霖
大木奈津子	奈津子
孙少强（曾用名）	孙乐天
张墨惜	张明伟
微群：https:	艾梦欣
张磊	张云雷
小辫儿	张云雷
小巧	吕伏阳
莫小巧	吕伏阳
陳詠燊	陈咏燊
杜历	杜景峰
阿哲	陈泽耀
元元	邹元清
火火（昵称）李炎（本名）	李火火
甄颖珊	甄咏珊
陈官鸿	官鸿
石佩灵	石美娟
俞萱	俞艾辰
朱鑑然	朱鉴然
钟亮	钟久夫
张爽	张润
刘黎泉	吉米
古川	吉米
謝芷倫	谢芷伦
欣锴	林欣锴
阿锴	林欣锴
锴儿	林欣锴
小锴	林欣锴
瓷娃娃	姜彦希
杨婕	楊婕
李瑶	李垚
刘泳熙	刘泳希
张晔	张咏
千红	王洪千
宋鹏飞	鹏飞
何蓝	何蓝逗
端端	刘端端
阿纯	杜雨宸
刘洪悦	悦悦
西木小叶子、叶子	任叶君
张幽舞	幽舞越山
张炜（本名）	叶知秋
邢子皓	邢凯新
小狼	邢凯新
關嘉敏	关嘉敏
杨振元	苏凡
江宜蓉	江沂宸
甘明明	甘明
葉芷如	叶芷如
陈曼姿	陈欣妍
大文	郭文颐
莫枯	房伟
唐冉昕	唐昕
贾晓龙	贾子宸
迷路先生、清爷	叶常清
沐轲	李勇
萧寒	李勇
牟星	牟鑫
曾寶	曾淑雅
洪宇澄	鹿迅
陈学良	寒舞
陈艳姣	陈牧耶
甄淇	甄琪
王维家	毛不易
肉包子	钟易轩
朱佳珠	朱佳姝
妹大爷	应宝林
大个王刚	王刚
李裕民	李靖
余世騰	余世腾
杜文	德温·沃勒尔
西塞儿·博耶·拉斯姆森	西塞儿·拉斯姆森
丹麦天使	西塞儿·拉斯姆森
蛇精男	刘梓晨
莊梅岩	庄梅岩
金桔	胡向真
珍珠	胡向真
袁延哲	袁哲
江河	欧阳江河
郑非	郑隽尧
李铫	笑谈
康康	胡馨元
李清	李青
陈润华	陈子由
夏侯落枫	曹云图
曹旭鹏	曹云图
杨博舒	舒子
章缜翔	钟证祥
章证翔	钟证祥
章增祥	钟证祥
嘟嘟	张楠
轰叔	廖劲锋
宋阳	宋思嘉
简亓	马嘉祺
二维马	马嘉祺
陳炳銓	陈炳铨
末路未留	王坤
江少儀	江少仪
赵延京	高果
赵雪琴	赵雪芹
许建国	许森涛
王貽興	王贻兴
贻兴	王贻兴
梨汁、瑶瑶	胡丽芝
兔子,大爱	沈小爱
赛赛,小田螺,小金猪	金锣赛
赵振开	北岛
利哥	于利
戴维娜	戴潍娜
戈滨	刘戈滨
戈彬	刘戈滨
王世民	王振贤
王宸	王振贤
陈闻平	林闻恩
笑笑（昵称）	周笑琴
许俏妞	许芳铱
朱朱,11,棉花糖	朱怡欣
歐陽偉豪	欧阳伟豪
吴海龙	肥龙
张迟昱	张吃鱼
李嘉琦	辣目洋子
洋子	辣目洋子
钟梦沁	钟曼洋
波比	钟曼洋
马媛	马丹阳
李博超	博超
魏欢欢	魏小欢
星星（昵称）	向俞星
杨淏翔（本名）	杨九郎
葛苏展（本名）	葛苏展
小苍	张翔玲
冬哥	石蕊
黃集鋒	黄竣锋
李辉	冷昊泽
李翊宁	李丽霞
黑妹	李丽霞
孔令科	孔龙
小华	钟小华
索达吉	索达吉堪布
索达吉堪布仁波切	索达吉堪布
纸巾	苏子缙
纸巾老师	苏子缙
吴允丰	吴靖森
瑾瑾	钟瑾桦
小瑾	钟瑾桦
小时姐姐	黄时
璟儿	江璟儿
张飞	张嘉飞
张会苓	张荟玲
张芸苓	张荟玲
张荟苓	张荟玲
苏丽亚	苏丽娅
苏利亚	苏丽娅
蕉蕉椒娇娇	赵梦娇
胡迁	胡波
茨木GLVCK	傅汉源
失控哥	夏乾喆
程思佳	程思嘉
东山少爷	廖寰
警訊之花	马溱禧
馬溱禧	马溱禧
缄言	叶蘅
邱业恒	叶蘅
秀念	王成思
老何	何仲海
阮文涛	阮柏霖
小白	张鹤伦
林芮西	林琳奇
林菀	林琳奇
阿拉彤（笔名）	郭奕彤
徐娟娟	徐巾淇
赵雪盈	赵雪莹
棣棣	王鹤棣
丁嘉瑞	丁一森
太康	陈张太康
泽西锅	陈张太康
星河	陈张太康
天悬星河	陈张太康
梁绘濠	梁证嘉
桦儿	陈芊桦
杨洋	杨明逸
庄宇凡	庄深沉
柏天男	栢天男
GAI爷	周延
球球	赵一涵
周闰发	郑晓勇
中村祖	中村让
赵今夏	赵悦
王蕊	王俏霖
王蕊蕊	王俏霖
陈启玄	陈瑛麟
孙逊	孙迅
锐哥、周美锐	周锐
李宝元	李保元
梁娇颖	梁心羽
阴璀妹	任玫
王晨	王辰硕
李瀚宇	李九霖
李春旭	李九霖
紫宁	张紫宁
张紫宁	张紫宁
宁鹅	张紫宁
刘明和	李家亮
关逸扬	关逸基
歐鎧淳	欧铠淳
歐凱淳	欧铠淳
小哲	魏哲鸣
南南	邱赫南
南南	邱赫南
邱士杰	邱赫南
朱哿	朱晓鹏
江小鱼	江钰婷
卢建发	天津喜哥
梦多	大谷主水
God 程潇	程潇
深圳一姐	程潇
姜媛	姜嫄
薛成	瞳音
娃娃	王逸宸
大象	慧明
蔡镇鸿（原名）	谢帝
张张，park	张赫
李柚	李子游
张玉娇	娇娇
可儿（小名）	康潇诺
兔兔（乳名）	康潇诺
郭映	郭泱
罗旭	罗方序
阿O	蒙为亮
邵钊	邵老五
邵羲	邵老五
齊騛	齐騛
闫京伟	闫博钦
钟逸伦	钟逸伦
旻极	王旻极
叶子金	靳烨
栗啊栗子妹	龙梦柔
张鹏	张朋
赵先生	鹏少
鑫仔、鑫鑫、鑫哥	陈鑫鑫
一 一	刘一菲
小青十二月	何阳青青
小镜子	高志娴
龙光维（本名）	山鬼
王昊	王厂长
卡拉（昵称）	姜卓君
玲玲 张玲玲	张玲玲
晴天,晴晴	李晴
饼饼	张爱静
朕,腻腻	郑洁丽
牧童阿星（曾用名）	何荣欣
七七,柒宝	王菲妍
银子	张羽涵
册子	李姗姗
熙琳	廖殷曼
嘏嘏	殷玉洲
沐岚	葛凌芮
王博	王玮
叶幸运	乐帕·温帕尼
冢田典彦	佃典彦
咩咩	杨凝
蒸肉饼	郑锐彬
赵晨	赵泓晨
蒋聘婷	蒋娉婷
覃杰	覃傑
李俊婷	李小木
白云	徐一娢
铁南	铁男
陈国羲	陈国义
李善玉	李紫菻
李奕含	李奕泽
李俊杰	李奕泽
蒿怡菲	蒿怡霏
贝思·肯尼迪	贝丝·肯尼迪
沐沐 大伯	韩沐伯
社会瑶	靖佩瑶
墨墨	秦子墨
小黑兔	秦子墨
小叶子	左叶
王思语	王艳梅
潘彰明	潘章明
拉丁小胖	何雄飞
舒奕橙	舒敦杭
褚珺阿姨	褚珺
褚珺大大	褚珺
李洋	李卓阳
张蓓瑜	张倍瑜
超级农农	陈立农
吴娜	吴潇娜
林靜苗	林静苗
小鬼	王琳凯
王秋翔	桑吉平措
山支大哥	孟美岐
毛毛球	孟美岐
美皮	孟美岐
小选	吴宣仪
五选一	吴宣仪
海南甜豆	吴宣仪
谈谈情	彭美凤
凯文·R·亚当斯	安恪温
涂小鸦	王敏纳
疯疯	疯子
杰米·埃迪	婕咪·埃迪
奶茶	商振博
卡珊德拉·亨德利	卡茜·亨德利
莎玛·耶雅莫娃	萨玛尔·叶斯利亚莫娃
小傅	傅菁
奶菁	傅菁
小奶狮	傅菁
姜世伟	芒克
土哥	闰土
蘑菇	蘑菇头
小明	猪小明
牛马	牛欣炜
李梓晨	李梓辰
刘军	庸人
阿海	胡海涛
侯大力	大力
老歪	罗沐
胡鹏（本名）皓翔（昵称）	胡皓翔
朱孟黎	朱莉
梁小七	梁彦增
小彩虹	徐梦洁
藍藍	藍雅芸
林小堂	林小棠
卢云飞	卢云
吴伟（原名）	吴逸迦
曲征明	曲征铭
鳕熊	魏小也
陈云	陈萌希
海豚	陈萌希
萌希	陈萌希
李蓝妮	施南
梁秋毅	梁文弋
乾乾	韩昊霖
韩韩	韩项远
韩少	韩项远
韩三少	韩项远
小猪	何雨瞬
婉婉（昵称）	龚婉怡
饭五婉（昵称）	龚婉怡
陈又宁	陈佑宁
富江	富冠铭
徐晓丹	许晓丹
利昂霖	李昂霖
阿本	翁瑞迪
長谷川 育美	长谷川育美
萧齐	肖齐
牛哥	牛钸斯
罗纯友	罗彬
芊芊	卢小娟
猫姐	谭宫柔真
嘉文	谭宫柔真
鲍勃辛	辛爽
凯凯	郭凯
吴霞	吴暇
曲河	阙迪伟
刘力纳	刘家瑜
邓瑾妮	邓瑾铌
灿坨	黎灿
沈贻炜	沈贻伟
波多野卷菜花	柏欣妤
白白	柏欣妤
赵育毕	赵玉碧
赵育碧	赵玉碧
赵玉毕	赵玉碧
卢延团	卢冠东
蕊宝	李欣蕊
蕊蕊	李欣蕊
汪普泽	汪普则
楚建富	楚建
阿曼达·韦斯	大牛
慧凌	陈慧凌
仙儿	张雪
张怡	张依墨
基bre	肖鹤
孙乙亓	孙嘉琪
皇上	李世民
仙女	娜琴
阿飞	张快
杨陆	杨璐
赵娅伟（本名）	玮子
黑先生	刘世杰
阿杰	刘世杰
思密达	郎鹤焱
大黄	郎鹤焱
小郎	郎鹤焱
仓井玛丽炎	郎鹤焱
钱景峰	庞景峰
钱浩然	庞景峰
乌尔坤别克·白山拜	别克
王潭	王谭
雷洋	雷濛
吐尔逊娜依·依不拉音江	吐尔逊娜依
李虹	李红
查查	查文浩
査文浩	查文浩
李迎春	李品夆
赵晏伯	赵晏博
谢小虎	谢飞虎
茉莉夫人	朱莉娅·茉莉
柯衍昱	柯黎
马修·诺勒斯	马泰
展展	徐依所
浩浩	黄浩鸣
黄教主	黄浩鸣
李佳芯	栗子儿
栗子欣	栗子儿
王俊	王沐霖
馀仲慰	余仲慰
范祥	范翔
徐颖	徐菁遥
王缇	王媞
船姐	何之舟
麥詠楠	麦咏楠
付小源	傅小源
刘心宇	刘心妤
龙思淇	祯襄
龙晶	祯襄
刘妍兵	刘妍冰
达达娃	朱哲琴
朱殊	朱姝
尹静	一静
张佩钰	张珮珏
百川	钟勇
包包	包海青
杨梢	杨展业
